dateTime,connectStart,secureConnectionStart,requestStart,responseStart,networkTime,serverTime,service site,searching string
2023-12-04 19:34:00,70,92,166,360,22,172,Bing,Carnegie Mellon University
2023-12-04 19:34:02,300,339,500,612,39,73,Amazon,Carnegie Mellon University
2023-12-04 19:34:11,150,176,649,801,26,126,Youtube,Carnegie Mellon University
2023-12-04 19:34:15,7,28,63,137,21,53,Bing,Airbnb
2023-12-04 19:34:16,18,55,103,165,37,25,Amazon,Airbnb
2023-12-04 19:34:20,3,26,184,246,23,39,Youtube,Airbnb
2023-12-04 19:34:24,7,27,61,215,20,134,Bing,Facebook
2023-12-04 19:34:24,21,57,103,166,36,27,Amazon,Facebook
2023-12-04 19:34:26,5,28,186,256,23,47,Youtube,Facebook
2023-12-04 19:34:32,39,60,182,378,21,175,Bing,Youtube
2023-12-04 19:34:32,10,50,114,179,40,25,Amazon,Youtube
2023-12-04 19:34:34,3,27,185,246,24,37,Youtube,Youtube
2023-12-04 19:34:39,7,75,294,384,68,22,Bing,cirtic
2023-12-04 19:34:40,11,176,342,519,165,12,Amazon,cirtic
2023-12-04 19:34:43,3,99,459,618,96,63,Youtube,cirtic
2023-12-04 19:34:51,10,31,203,378,21,154,Bing,when would there be
2023-12-04 19:34:52,31,79,132,199,48,19,Amazon,when would there be
2023-12-04 19:34:55,3,24,196,267,21,50,Youtube,when would there be
2023-12-04 19:34:59,8,175,231,555,167,157,Bing,search the map for new
2023-12-04 19:35:00,5,85,245,403,80,78,Amazon,search the map for new
2023-12-04 19:35:03,3,32,193,258,29,36,Youtube,search the map for new
2023-12-04 19:35:08,8,29,122,498,21,355,Bing,suggestions on finals
2023-12-04 19:35:17,8,29,66,308,21,221,Bing,start
2023-12-04 19:35:18,5,88,282,458,83,93,Amazon,start
2023-12-04 19:35:26,35,56,143,331,21,167,Bing,ending
2023-12-04 19:35:28,11,159,321,495,148,26,Amazon,ending
2023-12-04 19:35:32,3,92,316,491,89,86,Youtube,ending
2023-12-04 19:35:37,10,31,113,205,21,71,Bing,safety
2023-12-04 19:35:40,3,149,474,652,146,32,Youtube,safety
2023-12-04 19:35:45,6,27,69,143,21,53,Bing,data
2023-12-04 19:35:46,5,183,255,455,178,22,Amazon,data
2023-12-04 19:35:55,8,30,67,316,22,227,Bing,DDIO
2023-12-04 19:35:56,9,159,354,529,150,25,Amazon,DDIO
2023-12-04 19:36:00,4,114,345,525,110,70,Youtube,DDIO
2023-12-04 19:36:05,9,39,106,319,30,183,Bing,MSFG
2023-12-04 19:36:06,10,141,299,454,131,24,Amazon,MSFG
2023-12-04 19:36:09,4,60,355,517,56,106,Youtube,MSFG
2023-12-04 19:36:13,8,33,98,172,25,49,Bing,HOA
2023-12-04 19:36:14,14,59,260,360,45,55,Amazon,HOA
2023-12-04 19:36:19,3,79,396,575,76,103,Youtube,HOA
2023-12-04 19:36:24,14,84,292,379,70,17,Bing,FAFR
2023-12-04 19:36:32,7,30,80,156,23,53,Bing,WieSOichDichEmpfangen
2023-12-04 19:36:33,8,195,244,490,187,59,Amazon,WieSOichDichEmpfangen
2023-12-04 19:36:44,7,135,311,628,128,189,Amazon,sagmichbitte
2023-12-04 19:36:47,3,88,604,788,85,99,Youtube,sagmichbitte
2023-12-04 19:36:51,26,47,82,156,21,53,Bing,ilAuraitSuffi
2023-12-04 19:36:52,10,74,272,357,64,21,Amazon,ilAuraitSuffi
2023-12-04 19:36:58,3,173,548,727,170,9,Youtube,ilAuraitSuffi
2023-12-04 19:37:13,8,170,342,507,162,3,Bing,Carnegie Mellon University
2023-12-04 19:37:14,7,127,365,598,120,113,Amazon,Carnegie Mellon University
2023-12-04 19:37:17,4,26,189,278,22,67,Youtube,Carnegie Mellon University
2023-12-04 19:37:22,78,275,318,577,197,62,Bing,Airbnb
2023-12-04 19:37:23,5,87,192,316,82,42,Amazon,Airbnb
2023-12-04 19:37:30,6,27,64,138,21,53,Bing,Facebook
2023-12-04 19:37:39,39,59,102,266,20,144,Bing,Youtube
2023-12-04 19:37:45,5,159,536,724,154,34,Youtube,Youtube
2023-12-04 19:37:49,7,29,72,264,22,170,Bing,cirtic
2023-12-04 19:37:51,4,108,275,448,104,69,Amazon,cirtic
2023-12-04 19:37:56,4,113,333,528,109,86,Youtube,cirtic
2023-12-04 19:38:00,9,161,206,500,152,142,Bing,when would there be
2023-12-04 19:38:01,7,151,322,487,144,21,Amazon,when would there be
2023-12-04 19:38:03,5,28,185,253,23,45,Youtube,when would there be
2023-12-04 19:38:08,9,31,67,144,22,55,Bing,search the map for new
2023-12-04 19:38:18,7,31,70,161,24,67,Bing,suggestions on finals
2023-12-04 19:38:28,9,155,192,434,146,96,Bing,start
2023-12-04 19:38:29,6,161,321,497,155,21,Amazon,start
2023-12-04 19:38:34,3,97,315,501,94,92,Youtube,start
2023-12-04 19:38:38,7,81,115,438,74,249,Bing,ending
2023-12-04 19:38:39,6,86,162,275,80,33,Amazon,ending
2023-12-04 19:38:47,10,78,128,382,68,186,Bing,safety
2023-12-04 19:38:52,4,28,302,476,24,150,Youtube,safety
2023-12-04 19:38:56,7,28,65,139,21,53,Bing,data
2023-12-04 19:38:56,9,61,104,166,52,10,Amazon,data
2023-12-04 19:38:58,3,24,180,244,21,43,Youtube,data
2023-12-04 19:39:03,6,27,71,149,21,57,Bing,DDIO
2023-12-04 19:39:03,86,123,171,234,37,26,Amazon,DDIO
2023-12-04 19:39:05,4,38,203,285,34,48,Youtube,DDIO
2023-12-04 19:39:09,7,29,70,146,22,54,Bing,MSFG
2023-12-04 19:39:10,8,45,94,160,37,29,Amazon,MSFG
2023-12-04 19:39:12,3,25,186,254,22,46,Youtube,MSFG
2023-12-04 19:39:16,8,29,75,165,21,69,Bing,HOA
2023-12-04 19:39:16,8,48,94,157,40,23,Amazon,HOA
2023-12-04 19:39:19,4,28,183,256,24,49,Youtube,HOA
2023-12-04 19:39:24,7,29,67,143,22,54,Bing,FAFR
2023-12-04 19:39:24,5,42,90,158,37,31,Amazon,FAFR
2023-12-04 19:39:27,3,25,182,247,22,43,Youtube,FAFR
2023-12-04 19:39:31,7,31,66,133,24,43,Bing,WieSOichDichEmpfangen
2023-12-04 19:39:32,25,65,113,174,40,21,Amazon,WieSOichDichEmpfangen
2023-12-04 19:39:33,3,25,187,259,22,50,Youtube,WieSOichDichEmpfangen
2023-12-04 19:39:38,7,27,62,127,20,45,Bing,sagmichbitte
2023-12-04 19:39:38,19,57,104,168,38,26,Amazon,sagmichbitte
2023-12-04 19:39:40,6,29,181,244,23,40,Youtube,sagmichbitte
2023-12-04 19:39:44,8,30,69,141,22,50,Bing,ilAuraitSuffi
2023-12-04 19:39:44,21,59,107,171,38,26,Amazon,ilAuraitSuffi
2023-12-04 19:39:46,4,27,186,260,23,51,Youtube,ilAuraitSuffi
2023-12-04 19:40:00,32,53,89,166,21,56,Bing,Carnegie Mellon University
2023-12-04 19:40:03,3,24,185,257,21,51,Youtube,Carnegie Mellon University
2023-12-04 19:40:07,8,31,72,214,23,119,Bing,Airbnb
2023-12-04 19:40:08,7,48,93,160,41,26,Amazon,Airbnb
2023-12-04 19:40:10,3,25,179,257,22,56,Youtube,Airbnb
2023-12-04 19:40:14,24,46,84,151,22,45,Bing,Facebook
2023-12-04 19:40:14,5,44,90,158,39,29,Amazon,Facebook
2023-12-04 19:40:17,28,51,206,280,23,51,Youtube,Facebook
2023-12-04 19:40:21,8,29,70,141,21,50,Bing,Youtube
2023-12-04 19:40:21,57,95,142,203,38,23,Amazon,Youtube
2023-12-04 19:40:23,6,27,205,279,21,53,Youtube,Youtube
2023-12-04 19:40:28,18,41,85,154,23,46,Bing,cirtic
2023-12-04 19:40:28,18,55,101,164,37,26,Amazon,cirtic
2023-12-04 19:40:30,5,29,197,258,24,37,Youtube,cirtic
2023-12-04 19:40:34,10,31,71,295,21,203,Bing,when would there be
2023-12-04 19:40:34,16,53,99,160,37,24,Amazon,when would there be
2023-12-04 19:40:37,3,25,193,255,22,40,Youtube,when would there be
2023-12-04 19:40:41,12,33,74,148,21,53,Bing,search the map for new
2023-12-04 19:40:41,15,54,100,168,39,29,Amazon,search the map for new
2023-12-04 19:40:43,2,23,176,240,21,43,Youtube,search the map for new
2023-12-04 19:40:48,9,30,67,138,21,50,Bing,suggestions on finals
2023-12-04 19:40:48,17,54,101,164,37,26,Amazon,suggestions on finals
2023-12-04 19:40:51,3,23,177,238,20,41,Youtube,suggestions on finals
2023-12-04 19:40:55,6,27,66,132,21,45,Bing,start
2023-12-04 19:40:56,6,43,90,151,37,24,Amazon,start
2023-12-04 19:40:58,3,29,189,262,26,47,Youtube,start
2023-12-04 19:41:03,8,28,63,143,20,60,Bing,ending
2023-12-04 19:41:03,7,43,91,154,36,27,Amazon,ending
2023-12-04 19:41:05,4,26,185,252,22,45,Youtube,ending
2023-12-04 19:41:10,6,28,62,166,22,82,Bing,safety
2023-12-04 19:41:10,7,45,94,155,38,23,Amazon,safety
2023-12-04 19:41:13,5,28,204,285,23,58,Youtube,safety
2023-12-04 19:41:18,45,65,109,175,20,46,Bing,data
2023-12-04 19:41:18,17,55,103,168,38,27,Amazon,data
2023-12-04 19:41:20,3,26,179,258,23,56,Youtube,data
2023-12-04 19:41:24,7,29,67,143,22,54,Bing,DDIO
2023-12-04 19:41:24,9,49,95,165,40,30,Amazon,DDIO
2023-12-04 19:41:27,4,26,181,247,22,44,Youtube,DDIO
2023-12-04 19:41:31,7,28,62,129,21,46,Bing,MSFG
2023-12-04 19:41:31,5,45,91,158,40,27,Amazon,MSFG
2023-12-04 19:41:34,3,25,179,241,22,40,Youtube,MSFG
2023-12-04 19:41:38,27,50,85,159,23,51,Bing,HOA
2023-12-04 19:41:39,37,74,120,187,37,30,Amazon,HOA
2023-12-04 19:41:41,3,26,182,261,23,56,Youtube,HOA
2023-12-04 19:41:46,8,32,69,149,24,56,Bing,FAFR
2023-12-04 19:41:46,13,50,97,156,37,22,Amazon,FAFR
2023-12-04 19:41:48,6,28,197,267,22,48,Youtube,FAFR
2023-12-04 19:41:52,8,31,69,152,23,60,Bing,WieSOichDichEmpfangen
2023-12-04 19:41:53,10,51,95,157,41,21,Amazon,WieSOichDichEmpfangen
2023-12-04 19:41:54,10,33,196,271,23,52,Youtube,WieSOichDichEmpfangen
2023-12-04 19:41:59,6,28,67,135,22,46,Bing,sagmichbitte
2023-12-04 19:41:59,6,43,89,153,37,27,Amazon,sagmichbitte
2023-12-04 19:42:01,4,29,197,272,25,50,Youtube,sagmichbitte
2023-12-04 19:42:06,10,32,71,141,22,48,Bing,ilAuraitSuffi
2023-12-04 19:42:06,12,49,96,160,37,27,Amazon,ilAuraitSuffi
2023-12-04 19:42:09,3,24,176,246,21,49,Youtube,ilAuraitSuffi
dateTime,connectStart,secureConnectionStart,requestStart,responseStart,networkTime,serverTime,service site,searching string
2023-12-04 19:34:07,5,90,125,408,85,198,Bing,Carnegie Mellon University
2023-12-04 19:34:08,8,147,271,448,139,38,Amazon,Carnegie Mellon University
2023-12-04 19:34:18,5,27,62,128,22,44,Bing,Airbnb
2023-12-04 19:34:18,9,46,95,157,37,25,Amazon,Airbnb
2023-12-04 19:34:21,3,25,195,269,22,52,Youtube,Airbnb
2023-12-04 19:34:26,9,34,88,151,25,38,Bing,Facebook
2023-12-04 19:34:26,15,52,100,164,37,27,Amazon,Facebook
2023-12-04 19:34:28,8,41,197,269,33,39,Youtube,Facebook
2023-12-04 19:34:32,10,33,81,225,23,121,Bing,Youtube
2023-12-04 19:34:33,11,53,108,182,42,32,Amazon,Youtube
2023-12-04 19:34:35,2,24,195,267,22,50,Youtube,Youtube
2023-12-04 19:34:39,8,39,245,344,31,68,Bing,cirtic
2023-12-04 19:34:40,15,143,309,486,128,49,Amazon,cirtic
2023-12-04 19:34:43,4,98,457,616,94,65,Youtube,cirtic
2023-12-04 19:34:51,196,376,415,711,180,116,Bing,when would there be
2023-12-04 19:34:52,9,50,122,215,41,52,Amazon,when would there be
2023-12-04 19:34:54,3,63,233,318,60,25,Youtube,when would there be
2023-12-04 19:35:00,168,256,360,475,88,27,Amazon,search the map for new
2023-12-04 19:35:08,10,95,133,473,85,255,Bing,suggestions on finals
2023-12-04 19:35:17,7,75,124,373,68,181,Bing,start
2023-12-04 19:35:18,16,154,312,488,138,38,Amazon,start
2023-12-04 19:35:23,2,72,297,477,70,110,Youtube,start
2023-12-04 19:35:27,6,118,157,316,112,47,Bing,ending
2023-12-04 19:35:31,3,161,523,683,158,2,Youtube,ending
2023-12-04 19:35:36,7,30,69,142,23,50,Bing,safety
2023-12-04 19:35:37,5,147,342,519,142,35,Amazon,safety
2023-12-04 19:35:45,6,85,122,380,79,179,Bing,data
2023-12-04 19:35:47,8,174,337,518,166,15,Amazon,data
2023-12-04 19:35:50,2,79,315,658,77,266,Youtube,data
2023-12-04 19:35:55,29,51,92,364,22,250,Bing,DDIO
2023-12-04 19:35:56,11,156,351,527,145,31,Amazon,DDIO
2023-12-04 19:36:00,4,113,343,524,109,72,Youtube,DDIO
2023-12-04 19:36:05,8,68,107,347,60,180,Bing,MSFG
2023-12-04 19:36:06,9,161,319,474,152,3,Amazon,MSFG
2023-12-04 19:36:09,4,96,461,622,92,69,Youtube,MSFG
2023-12-04 19:36:13,87,113,155,261,26,80,Bing,HOA
2023-12-04 19:36:14,9,55,103,175,46,26,Amazon,HOA
2023-12-04 19:36:18,5,73,483,670,68,119,Youtube,HOA
2023-12-04 19:36:23,7,28,66,133,21,46,Bing,FAFR
2023-12-04 19:36:24,219,314,540,815,95,180,Amazon,FAFR
2023-12-04 19:36:32,7,29,69,151,22,60,Bing,WieSOichDichEmpfangen
2023-12-04 19:36:33,6,43,92,163,37,34,Amazon,WieSOichDichEmpfangen
2023-12-04 19:36:39,2,177,390,575,175,10,Youtube,WieSOichDichEmpfangen
2023-12-04 19:36:44,8,95,138,451,87,226,Bing,sagmichbitte
2023-12-04 19:36:52,15,43,97,168,28,43,Bing,ilAuraitSuffi
2023-12-04 19:36:58,3,169,522,701,166,13,Youtube,ilAuraitSuffi
2023-12-04 19:37:13,7,149,321,486,142,23,Bing,Carnegie Mellon University
2023-12-04 19:37:14,26,141,378,610,115,117,Amazon,Carnegie Mellon University
2023-12-04 19:37:16,5,28,194,271,23,54,Youtube,Carnegie Mellon University
2023-12-04 19:37:26,4,155,504,666,151,11,Youtube,Airbnb
2023-12-04 19:37:30,11,35,78,422,24,320,Bing,Facebook
2023-12-04 19:37:31,10,115,278,457,105,74,Amazon,Facebook
2023-12-04 19:37:41,7,40,163,408,33,212,Bing,Youtube
2023-12-04 19:37:42,177,256,362,475,79,34,Amazon,Youtube
2023-12-04 19:37:50,10,73,292,388,63,33,Bing,cirtic
2023-12-04 19:37:51,7,145,194,490,138,158,Amazon,cirtic
2023-12-04 19:37:54,3,56,375,538,53,110,Youtube,cirtic
2023-12-04 19:37:59,80,101,177,370,21,172,Bing,when would there be
2023-12-04 19:38:00,6,147,195,513,141,177,Amazon,when would there be
2023-12-04 19:38:04,3,81,292,471,78,101,Youtube,when would there be
2023-12-04 19:38:09,9,30,119,296,21,156,Bing,search the map for new
2023-12-04 19:38:18,5,26,69,139,21,49,Bing,suggestions on finals
2023-12-04 19:38:30,7,117,300,438,110,28,Bing,start
2023-12-04 19:38:30,7,50,111,194,43,40,Amazon,start
2023-12-04 19:38:33,3,27,186,277,24,67,Youtube,start
2023-12-04 19:38:38,116,190,409,499,74,16,Bing,ending
2023-12-04 19:38:38,7,152,325,493,145,23,Amazon,ending
2023-12-04 19:38:42,3,91,615,778,88,75,Youtube,ending
2023-12-04 19:38:47,8,171,212,448,163,73,Bing,safety
2023-12-04 19:38:48,8,143,300,451,135,16,Amazon,safety
2023-12-04 19:38:52,4,27,301,477,23,153,Youtube,safety
2023-12-04 19:38:56,52,73,112,181,21,48,Bing,data
2023-12-04 19:38:57,6,42,89,154,36,29,Amazon,data
2023-12-04 19:38:59,5,58,222,290,53,15,Youtube,data
2023-12-04 19:39:04,7,29,65,207,22,120,Bing,DDIO
2023-12-04 19:39:04,11,58,112,181,47,22,Amazon,DDIO
2023-12-04 19:39:06,5,29,198,268,24,46,Youtube,DDIO
2023-12-04 19:39:10,8,39,87,158,31,40,Bing,MSFG
2023-12-04 19:39:11,15,52,98,160,37,25,Amazon,MSFG
2023-12-04 19:39:13,3,26,192,258,23,43,Youtube,MSFG
2023-12-04 19:39:18,8,30,73,142,22,47,Bing,HOA
2023-12-04 19:39:18,9,49,107,170,40,23,Amazon,HOA
2023-12-04 19:39:21,5,27,187,266,22,57,Youtube,HOA
2023-12-04 19:39:25,7,28,76,147,21,50,Bing,FAFR
2023-12-04 19:39:26,5,43,95,157,38,24,Amazon,FAFR
2023-12-04 19:39:28,4,27,192,274,23,59,Youtube,FAFR
2023-12-04 19:39:32,9,32,74,183,23,86,Bing,WieSOichDichEmpfangen
2023-12-04 19:39:33,22,59,107,173,37,29,Amazon,WieSOichDichEmpfangen
2023-12-04 19:39:35,3,29,198,272,26,48,Youtube,WieSOichDichEmpfangen
2023-12-04 19:39:39,6,27,64,133,21,48,Bing,sagmichbitte
2023-12-04 19:39:39,11,48,98,167,37,32,Amazon,sagmichbitte
2023-12-04 19:39:42,4,39,200,346,35,111,Youtube,sagmichbitte
2023-12-04 19:39:46,8,29,72,142,21,49,Bing,ilAuraitSuffi
2023-12-04 19:39:47,9,46,95,158,37,26,Amazon,ilAuraitSuffi
2023-12-04 19:39:48,4,26,185,244,22,37,Youtube,ilAuraitSuffi
2023-12-04 19:40:03,7,27,62,130,20,48,Bing,Carnegie Mellon University
2023-12-04 19:40:03,5,45,92,157,40,25,Amazon,Carnegie Mellon University
2023-12-04 19:40:05,6,29,198,270,23,49,Youtube,Carnegie Mellon University
2023-12-04 19:40:09,10,32,71,181,22,88,Bing,Airbnb
2023-12-04 19:40:10,17,56,104,167,39,24,Amazon,Airbnb
2023-12-04 19:40:11,4,32,190,271,28,53,Youtube,Airbnb
2023-12-04 19:40:16,8,30,72,167,22,73,Bing,Facebook
2023-12-04 19:40:16,6,43,95,159,37,27,Amazon,Facebook
2023-12-04 19:40:18,5,31,195,269,26,48,Youtube,Facebook
2023-12-04 19:40:22,12,44,93,167,32,42,Bing,Youtube
2023-12-04 19:40:23,8,46,98,160,38,24,Amazon,Youtube
2023-12-04 19:40:25,4,25,195,264,21,48,Youtube,Youtube
2023-12-04 19:40:30,8,29,71,263,21,171,Bing,cirtic
2023-12-04 19:40:31,22,59,105,169,37,27,Amazon,cirtic
2023-12-04 19:40:33,48,68,241,336,20,75,Youtube,cirtic
2023-12-04 19:40:37,10,33,82,307,23,202,Bing,when would there be
2023-12-04 19:40:38,8,49,96,158,41,21,Amazon,when would there be
2023-12-04 19:40:40,4,26,185,246,22,39,Youtube,when would there be
2023-12-04 19:40:45,8,31,70,305,23,212,Bing,search the map for new
2023-12-04 19:40:45,5,43,86,150,38,26,Amazon,search the map for new
2023-12-04 19:40:47,3,26,190,278,23,65,Youtube,search the map for new
2023-12-04 19:40:51,9,30,73,164,21,70,Bing,suggestions on finals
2023-12-04 19:40:51,14,52,99,164,38,27,Amazon,suggestions on finals
2023-12-04 19:40:53,4,26,190,253,22,41,Youtube,suggestions on finals
2023-12-04 19:40:57,7,29,68,141,22,51,Bing,start
2023-12-04 19:40:57,6,43,93,154,37,24,Amazon,start
2023-12-04 19:41:00,5,32,187,285,27,71,Youtube,start
2023-12-04 19:41:04,7,28,68,134,21,45,Bing,ending
2023-12-04 19:41:05,8,46,90,153,38,25,Amazon,ending
2023-12-04 19:41:07,3,31,193,274,28,53,Youtube,ending
2023-12-04 19:41:12,11,34,74,169,23,72,Bing,safety
2023-12-04 19:41:12,6,46,93,155,40,22,Amazon,safety
2023-12-04 19:41:15,3,24,180,260,21,59,Youtube,safety
2023-12-04 19:41:20,8,31,74,144,23,47,Bing,data
2023-12-04 19:41:20,8,44,91,154,36,27,Amazon,data
2023-12-04 19:41:22,4,28,188,256,24,44,Youtube,data
2023-12-04 19:41:26,8,29,64,164,21,79,Bing,DDIO
2023-12-04 19:41:26,9,46,102,182,37,43,Amazon,DDIO
2023-12-04 19:41:29,4,26,210,284,22,52,Youtube,DDIO
2023-12-04 19:41:33,8,29,72,139,21,46,Bing,MSFG
2023-12-04 19:41:34,10,53,118,187,43,26,Amazon,MSFG
2023-12-04 19:41:36,4,27,185,253,23,45,Youtube,MSFG
2023-12-04 19:41:40,8,30,68,134,22,44,Bing,HOA
2023-12-04 19:41:40,9,48,94,160,39,27,Amazon,HOA
2023-12-04 19:41:43,6,69,225,294,63,6,Youtube,HOA
2023-12-04 19:41:47,8,29,70,138,21,47,Bing,FAFR
2023-12-04 19:41:48,9,48,97,168,39,32,Amazon,FAFR
2023-12-04 19:41:50,3,26,185,264,23,56,Youtube,FAFR
2023-12-04 19:41:54,10,32,74,155,22,59,Bing,WieSOichDichEmpfangen
2023-12-04 19:41:55,11,50,96,162,39,27,Amazon,WieSOichDichEmpfangen
2023-12-04 19:41:57,2,29,189,255,27,39,Youtube,WieSOichDichEmpfangen
2023-12-04 19:42:01,8,29,73,139,21,45,Bing,sagmichbitte
2023-12-04 19:42:02,12,49,95,161,37,29,Amazon,sagmichbitte
2023-12-04 19:42:03,8,36,191,266,28,47,Youtube,sagmichbitte
2023-12-04 19:42:08,6,29,70,140,23,47,Bing,ilAuraitSuffi
2023-12-04 19:42:08,12,51,101,165,39,25,Amazon,ilAuraitSuffi
2023-12-04 19:42:11,5,28,190,269,23,56,Youtube,ilAuraitSuffi
