dateTime,connectStart,secureConnectionStart,requestStart,responseStart,networkTime,serverTime,service site,searching string
2023-12-04 22:50:48,213,246,295,371,33,43,Bing,Carnegie Mellon University
2023-12-04 22:50:50,120,173,221,334,53,60,Amazon,Carnegie Mellon University
2023-12-04 22:50:54,91,142,358,626,51,217,Youtube,Carnegie Mellon University
2023-12-04 22:50:58,5,38,87,166,33,46,Bing,Airbnb
2023-12-04 22:50:59,5,42,88,213,37,88,Amazon,Airbnb
2023-12-04 22:51:02,42,93,266,373,51,56,Youtube,Airbnb
2023-12-04 22:51:06,8,41,101,179,33,45,Bing,Facebook
2023-12-04 22:51:07,5,39,87,216,34,95,Amazon,Facebook
2023-12-04 22:51:09,52,103,277,383,51,55,Youtube,Facebook
2023-12-04 22:51:14,6,85,141,230,79,10,Bing,Youtube
2023-12-04 22:51:16,5,39,80,197,34,83,Amazon,Youtube
2023-12-04 22:51:19,54,217,387,697,163,147,Youtube,Youtube
2023-12-04 22:51:23,6,39,85,162,33,44,Bing,cirtic
2023-12-04 22:51:24,4,40,85,223,36,102,Amazon,cirtic
2023-12-04 22:51:27,37,81,248,352,44,60,Youtube,cirtic
2023-12-04 22:51:31,6,39,100,197,33,64,Bing,when would there be
2023-12-04 22:51:32,4,36,88,216,32,96,Amazon,when would there be
2023-12-04 22:51:34,42,89,262,363,47,54,Youtube,when would there be
2023-12-04 22:51:38,40,74,124,208,34,50,Bing,search the map for new
2023-12-04 22:51:40,99,137,182,318,38,98,Amazon,search the map for new
2023-12-04 22:51:43,55,104,275,369,49,45,Youtube,search the map for new
2023-12-04 22:51:47,73,108,163,237,35,39,Bing,suggestions on finals
2023-12-04 22:51:48,12,46,92,226,34,100,Amazon,suggestions on finals
2023-12-04 22:51:51,43,90,264,375,47,64,Youtube,suggestions on finals
2023-12-04 22:51:55,7,39,87,299,32,180,Bing,start
2023-12-04 22:51:57,3,37,83,225,34,108,Amazon,start
2023-12-04 22:52:00,43,89,266,375,46,63,Youtube,start
2023-12-04 22:52:04,7,47,101,232,40,91,Bing,ending
2023-12-04 22:52:06,4,37,87,226,33,106,Amazon,ending
2023-12-04 22:52:08,40,85,263,370,45,62,Youtube,ending
2023-12-04 22:52:12,42,76,133,227,34,60,Bing,safety
2023-12-04 22:52:14,4,39,83,205,35,87,Amazon,safety
2023-12-04 22:52:16,48,109,277,386,61,48,Youtube,safety
2023-12-04 22:52:21,7,42,101,179,35,43,Bing,data
2023-12-04 22:52:22,7,42,94,215,35,86,Amazon,data
2023-12-04 22:52:25,52,110,302,415,58,55,Youtube,data
2023-12-04 22:52:29,36,72,126,210,36,48,Bing,DDIO
2023-12-04 22:52:31,10,45,92,216,35,89,Amazon,DDIO
2023-12-04 22:52:35,39,90,262,372,51,59,Youtube,DDIO
2023-12-04 22:52:39,7,42,309,382,35,38,Bing,MSFG
2023-12-04 22:52:41,4,41,85,391,37,269,Amazon,MSFG
2023-12-04 22:52:45,46,98,383,480,52,45,Youtube,MSFG
2023-12-04 22:52:50,38,71,394,908,33,481,Bing,HOA
2023-12-04 22:52:55,44,231,424,713,187,102,Youtube,HOA
2023-12-04 22:53:01,41,83,127,251,42,82,Amazon,FAFR
2023-12-04 22:53:03,186,235,389,539,49,101,Youtube,FAFR
2023-12-04 22:53:08,245,305,360,736,60,316,Bing,WieSOichDichEmpfangen
2023-12-04 22:53:10,5,61,310,504,56,138,Amazon,WieSOichDichEmpfangen
2023-12-04 22:53:13,39,39,542,856,0,314,Youtube,WieSOichDichEmpfangen
2023-12-04 22:53:17,7,42,89,213,35,89,Bing,sagmichbitte
2023-12-04 22:53:19,3,37,281,431,34,116,Amazon,sagmichbitte
2023-12-04 22:53:21,38,116,264,367,78,25,Youtube,sagmichbitte
2023-12-04 22:53:25,37,78,124,392,41,227,Bing,ilAuraitSuffi
2023-12-04 22:53:27,7,42,85,200,35,80,Amazon,ilAuraitSuffi
2023-12-04 22:53:29,31,79,230,302,48,24,Youtube,ilAuraitSuffi
2023-12-04 22:53:43,7,47,97,176,40,39,Bing,Carnegie Mellon University
2023-12-04 22:53:45,7,45,86,213,38,89,Amazon,Carnegie Mellon University
2023-12-04 22:53:47,49,90,255,332,41,36,Youtube,Carnegie Mellon University
2023-12-04 22:53:51,44,82,198,503,38,267,Bing,Airbnb
2023-12-04 22:53:52,8,43,86,205,35,84,Amazon,Airbnb
2023-12-04 22:53:55,41,88,236,317,47,34,Youtube,Airbnb
2023-12-04 22:53:59,8,45,90,174,37,47,Bing,Facebook
2023-12-04 22:54:01,7,45,93,224,38,93,Amazon,Facebook
2023-12-04 22:54:03,51,97,255,336,46,35,Youtube,Facebook
2023-12-04 22:54:07,4,37,88,165,33,44,Bing,Youtube
2023-12-04 22:54:09,12,47,91,221,35,95,Amazon,Youtube
2023-12-04 22:54:11,60,107,266,356,47,43,Youtube,Youtube
2023-12-04 22:54:15,7,47,108,211,40,63,Bing,cirtic
2023-12-04 22:54:16,5,43,86,218,38,94,Amazon,cirtic
2023-12-04 22:54:19,50,96,249,331,46,36,Youtube,cirtic
2023-12-04 22:54:23,39,75,124,201,36,41,Bing,when would there be
2023-12-04 22:54:25,5,43,95,218,38,85,Amazon,when would there be
2023-12-04 22:54:27,52,98,254,332,46,32,Youtube,when would there be
2023-12-04 22:54:31,9,43,98,193,34,61,Bing,search the map for new
2023-12-04 22:54:33,6,40,83,212,34,95,Amazon,search the map for new
2023-12-04 22:54:35,44,93,246,325,49,30,Youtube,search the map for new
2023-12-04 22:54:39,6,41,89,203,35,79,Bing,suggestions on finals
2023-12-04 22:54:41,6,50,113,278,44,121,Amazon,suggestions on finals
2023-12-04 22:54:43,46,101,267,352,55,30,Youtube,suggestions on finals
2023-12-04 22:54:47,38,72,134,214,34,46,Bing,start
2023-12-04 22:54:49,4,38,83,222,34,105,Amazon,start
2023-12-04 22:54:51,48,92,251,331,44,36,Youtube,start
2023-12-04 22:54:55,41,78,127,230,37,66,Bing,ending
2023-12-04 22:54:57,4,41,84,200,37,79,Amazon,ending
2023-12-04 22:54:59,47,96,254,334,49,31,Youtube,ending
2023-12-04 22:55:03,7,45,99,293,38,156,Bing,safety
2023-12-04 22:55:05,38,73,120,284,35,129,Amazon,safety
2023-12-04 22:55:07,64,105,256,342,41,45,Youtube,safety
2023-12-04 22:55:11,8,42,90,184,34,60,Bing,data
2023-12-04 22:55:13,5,40,85,207,35,87,Amazon,data
2023-12-04 22:55:14,47,97,254,342,50,38,Youtube,data
2023-12-04 22:55:19,44,84,142,241,40,59,Bing,DDIO
2023-12-04 22:55:20,4,40,84,213,36,93,Amazon,DDIO
2023-12-04 22:55:22,48,102,294,373,54,25,Youtube,DDIO
2023-12-04 22:55:26,7,41,86,172,34,52,Bing,MSFG
2023-12-04 22:55:28,7,41,89,220,34,97,Amazon,MSFG
2023-12-04 22:55:30,45,96,253,338,51,34,Youtube,MSFG
2023-12-04 22:55:34,7,45,95,178,38,45,Bing,HOA
2023-12-04 22:55:36,127,160,205,335,33,97,Amazon,HOA
2023-12-04 22:55:38,42,84,237,320,42,41,Youtube,HOA
2023-12-04 22:55:43,43,81,135,641,38,468,Bing,FAFR
2023-12-04 22:55:45,5,92,277,440,87,76,Amazon,FAFR
2023-12-04 22:55:52,7,46,94,198,39,65,Bing,WieSOichDichEmpfangen
2023-12-04 22:55:53,5,41,85,215,36,94,Amazon,WieSOichDichEmpfangen
2023-12-04 22:55:54,36,80,242,318,44,32,Youtube,WieSOichDichEmpfangen
2023-12-04 22:55:58,8,48,97,183,40,46,Bing,sagmichbitte
2023-12-04 22:55:59,7,42,90,218,35,93,Amazon,sagmichbitte
2023-12-04 22:56:01,38,84,253,347,46,48,Youtube,sagmichbitte
2023-12-04 22:56:05,7,43,99,183,36,48,Bing,ilAuraitSuffi
2023-12-04 22:56:06,4,37,83,217,33,101,Amazon,ilAuraitSuffi
2023-12-04 22:56:08,37,83,236,317,46,35,Youtube,ilAuraitSuffi
2023-12-04 22:56:23,41,76,131,222,35,56,Bing,Carnegie Mellon University
2023-12-04 22:56:26,5,41,93,243,36,114,Amazon,Carnegie Mellon University
2023-12-04 22:56:28,48,100,276,367,52,39,Youtube,Carnegie Mellon University
2023-12-04 22:56:32,7,44,93,195,37,65,Bing,Airbnb
2023-12-04 22:56:34,4,41,90,228,37,101,Amazon,Airbnb
2023-12-04 22:56:36,48,95,269,361,47,45,Youtube,Airbnb
2023-12-04 22:56:41,38,73,127,441,35,279,Bing,Facebook
2023-12-04 22:56:43,5,41,94,466,36,336,Amazon,Facebook
2023-12-04 22:56:47,51,356,815,1205,305,85,Youtube,Facebook
2023-12-04 22:56:52,7,119,169,298,112,17,Bing,Youtube
2023-12-04 22:56:54,264,305,349,490,41,100,Amazon,Youtube
2023-12-04 22:57:01,46,95,155,323,49,119,Bing,cirtic
2023-12-04 22:57:04,4,41,89,325,37,199,Amazon,cirtic
2023-12-04 22:57:06,39,94,254,387,55,78,Youtube,cirtic
2023-12-04 22:57:10,50,89,145,484,39,300,Bing,when would there be
2023-12-04 22:57:13,6,42,102,235,36,97,Amazon,when would there be
2023-12-04 22:57:15,43,88,256,362,45,61,Youtube,when would there be
2023-12-04 22:57:19,6,44,105,246,38,103,Bing,search the map for new
2023-12-04 22:57:22,16,51,96,207,35,76,Amazon,search the map for new
2023-12-04 22:57:34,6,116,163,332,110,59,Amazon,suggestions on finals
2023-12-04 22:57:38,41,89,669,745,48,28,Youtube,suggestions on finals
2023-12-04 22:57:45,5,43,357,543,38,148,Amazon,start
2023-12-04 22:57:49,44,285,483,762,241,38,Youtube,start
2023-12-04 22:57:56,43,81,343,506,38,125,Amazon,ending
2023-12-04 22:57:59,121,179,360,444,58,26,Youtube,ending
2023-12-04 22:58:06,5,63,112,363,58,193,Amazon,safety
2023-12-04 22:58:09,51,98,469,555,47,39,Youtube,safety
2023-12-04 22:58:13,6,38,118,210,32,60,Bing,data
2023-12-04 22:58:15,6,54,104,260,48,108,Amazon,data
2023-12-04 22:58:18,49,112,279,368,63,26,Youtube,data
2023-12-04 22:58:23,215,252,299,377,37,41,Bing,DDIO
2023-12-04 22:58:25,6,47,321,459,41,97,Amazon,DDIO
2023-12-04 22:58:28,42,116,304,391,74,13,Youtube,DDIO
2023-12-04 22:58:32,9,45,184,286,36,66,Bing,MSFG
2023-12-04 22:58:34,5,40,82,207,35,90,Amazon,MSFG
2023-12-04 22:58:36,47,90,244,317,43,30,Youtube,MSFG
2023-12-04 22:58:40,42,79,146,234,37,51,Bing,HOA
2023-12-04 22:58:41,8,54,104,230,46,80,Amazon,HOA
2023-12-04 22:58:45,47,96,2150,2244,49,45,Youtube,HOA
2023-12-04 22:58:49,8,48,99,196,40,57,Bing,FAFR
2023-12-04 22:58:50,4,51,100,225,47,78,Amazon,FAFR
2023-12-04 22:58:53,51,103,251,338,52,35,Youtube,FAFR
2023-12-04 22:58:57,8,53,114,201,45,42,Bing,WieSOichDichEmpfangen
2023-12-04 22:58:58,39,73,128,249,34,87,Amazon,WieSOichDichEmpfangen
2023-12-04 22:59:00,33,77,230,328,44,54,Youtube,WieSOichDichEmpfangen
2023-12-04 22:59:04,12,45,98,173,33,42,Bing,sagmichbitte
2023-12-04 22:59:05,3,38,99,278,35,144,Amazon,sagmichbitte
2023-12-04 22:59:08,46,98,262,343,52,29,Youtube,sagmichbitte
2023-12-04 22:59:13,45,82,131,691,37,523,Bing,ilAuraitSuffi
2023-12-04 22:59:14,5,40,88,208,35,85,Amazon,ilAuraitSuffi
2023-12-04 22:59:17,46,97,252,330,51,27,Youtube,ilAuraitSuffi
