dateTime,connectStart,secureConnectionStart,requestStart,responseStart,networkTime,serverTime,service site,searching string
2023-12-04 14:01:45,49,74,120,182,25,37,Bing,Carnegie Mellon University
2023-12-04 14:01:47,67,97,133,240,30,77,Amazon,Carnegie Mellon University
2023-12-04 14:01:49,70,97,308,409,27,74,Youtube,Carnegie Mellon University
2023-12-04 14:01:54,7,35,80,159,28,51,Bing,Airbnb
2023-12-04 14:01:56,7,38,77,191,31,83,Amazon,Airbnb
2023-12-04 14:01:58,56,86,303,436,30,103,Youtube,Airbnb
2023-12-04 14:02:02,34,70,119,187,36,32,Bing,Facebook
2023-12-04 14:02:04,12,42,80,187,30,77,Amazon,Facebook
2023-12-04 14:02:06,47,84,229,313,37,47,Youtube,Facebook
2023-12-04 14:02:10,7,32,75,221,25,121,Bing,Youtube
2023-12-04 14:02:12,4,39,74,181,35,72,Amazon,Youtube
2023-12-04 14:02:14,43,72,232,304,29,43,Youtube,Youtube
2023-12-04 14:02:18,7,39,78,238,32,128,Bing,cirtic
2023-12-04 14:02:20,4,34,72,179,30,77,Amazon,cirtic
2023-12-04 14:02:22,55,87,233,320,32,55,Youtube,cirtic
2023-12-04 14:02:25,6,33,79,156,27,50,Bing,when would there be
2023-12-04 14:02:27,4,34,73,173,30,70,Amazon,when would there be
2023-12-04 14:02:29,47,81,233,314,34,47,Youtube,when would there be
2023-12-04 14:02:33,33,60,110,215,27,78,Bing,search the map for new
2023-12-04 14:02:35,5,33,74,184,28,82,Amazon,search the map for new
2023-12-04 14:02:39,56,90,226,306,34,46,Youtube,search the map for new
2023-12-04 14:02:43,7,37,76,145,30,39,Bing,suggestions on finals
2023-12-04 14:02:44,9,36,72,188,27,89,Amazon,suggestions on finals
2023-12-04 14:02:46,46,78,224,302,32,46,Youtube,suggestions on finals
2023-12-04 14:02:51,6,39,78,199,33,88,Bing,start
2023-12-04 14:02:53,9,38,77,182,29,76,Amazon,start
2023-12-04 14:02:55,45,82,248,382,37,97,Youtube,start
2023-12-04 14:02:59,6,34,81,204,28,95,Bing,ending
2023-12-04 14:03:01,6,34,70,207,28,109,Amazon,ending
2023-12-04 14:03:05,49,81,221,307,32,54,Youtube,ending
2023-12-04 14:03:09,38,66,106,173,28,39,Bing,safety
2023-12-04 14:03:11,64,91,127,234,27,80,Amazon,safety
2023-12-04 14:03:13,56,94,234,324,38,52,Youtube,safety
2023-12-04 14:03:17,7,33,72,163,26,65,Bing,data
2023-12-04 14:03:19,9,45,83,188,36,69,Amazon,data
2023-12-04 14:03:21,40,75,223,304,35,46,Youtube,data
2023-12-04 14:03:25,47,75,141,208,28,39,Bing,DDIO
2023-12-04 14:03:26,7,36,73,209,29,107,Amazon,DDIO
2023-12-04 14:03:29,45,86,226,307,41,40,Youtube,DDIO
2023-12-04 14:03:33,4,33,98,171,29,44,Bing,MSFG
2023-12-04 14:03:34,5,34,73,234,29,132,Amazon,MSFG
2023-12-04 14:03:36,53,87,228,313,34,51,Youtube,MSFG
2023-12-04 14:03:40,8,34,94,185,26,65,Bing,HOA
2023-12-04 14:03:42,7,43,86,190,36,68,Amazon,HOA
2023-12-04 14:03:45,58,93,249,322,35,38,Youtube,HOA
2023-12-04 14:03:49,34,60,126,198,26,46,Bing,FAFR
2023-12-04 14:03:51,5,35,78,184,30,76,Amazon,FAFR
2023-12-04 14:03:53,61,95,255,330,34,41,Youtube,FAFR
2023-12-04 14:03:57,6,33,95,167,27,45,Bing,WieSOichDichEmpfangen
2023-12-04 14:03:58,6,37,76,202,31,95,Amazon,WieSOichDichEmpfangen
2023-12-04 14:04:00,41,74,223,307,33,51,Youtube,WieSOichDichEmpfangen
2023-12-04 14:04:04,8,33,93,163,25,45,Bing,sagmichbitte
2023-12-04 14:04:05,5,48,86,187,43,58,Amazon,sagmichbitte
2023-12-04 14:04:08,39,70,220,298,31,47,Youtube,sagmichbitte
2023-12-04 14:04:13,5,34,101,214,29,84,Amazon,ilAuraitSuffi
2023-12-04 14:04:15,32,60,204,278,28,46,Youtube,ilAuraitSuffi
2023-12-04 14:04:29,7,32,72,149,25,52,Bing,Carnegie Mellon University
2023-12-04 14:04:31,58,88,128,233,30,75,Amazon,Carnegie Mellon University
2023-12-04 14:04:32,57,88,226,310,31,53,Youtube,Carnegie Mellon University
2023-12-04 14:04:37,6,34,81,147,28,38,Bing,Airbnb
2023-12-04 14:04:38,5,37,78,178,32,68,Amazon,Airbnb
2023-12-04 14:04:40,68,101,249,340,33,58,Youtube,Airbnb
2023-12-04 14:04:45,11,36,84,154,25,45,Bing,Facebook
2023-12-04 14:04:47,16,55,97,200,39,64,Amazon,Facebook
2023-12-04 14:04:48,87,117,269,343,30,44,Youtube,Facebook
2023-12-04 14:04:54,10,47,96,291,37,158,Bing,Youtube
2023-12-04 14:04:55,10,42,82,182,32,68,Amazon,Youtube
2023-12-04 14:04:57,63,102,257,333,39,37,Youtube,Youtube
2023-12-04 14:05:02,11,59,109,195,48,38,Bing,cirtic
2023-12-04 14:05:04,10,45,91,207,35,81,Amazon,cirtic
2023-12-04 14:05:11,10,43,100,194,33,61,Bing,when would there be
2023-12-04 14:05:12,18,46,87,198,28,83,Amazon,when would there be
2023-12-04 14:05:17,48,89,241,317,41,35,Youtube,when would there be
2023-12-04 14:05:22,15,45,91,161,30,40,Bing,search the map for new
2023-12-04 14:05:23,10,40,79,209,30,100,Amazon,search the map for new
2023-12-04 14:05:26,58,90,246,358,32,80,Youtube,search the map for new
2023-12-04 14:05:34,14,163,333,504,149,22,Amazon,suggestions on finals
2023-12-04 14:05:37,78,115,264,342,37,41,Youtube,suggestions on finals
2023-12-04 14:05:42,16,51,104,172,35,33,Bing,start
2023-12-04 14:05:45,24,58,99,220,34,87,Amazon,start
2023-12-04 14:05:47,64,97,232,313,33,48,Youtube,start
2023-12-04 14:05:52,9,37,91,160,28,41,Bing,ending
2023-12-04 14:05:54,14,45,88,185,31,66,Amazon,ending
2023-12-04 14:05:56,60,92,246,320,32,42,Youtube,ending
2023-12-04 14:06:01,9,34,84,392,25,283,Bing,safety
2023-12-04 14:06:03,12,45,87,211,33,91,Amazon,safety
2023-12-04 14:06:05,51,82,240,327,31,56,Youtube,safety
2023-12-04 14:06:10,50,80,142,212,30,40,Bing,data
2023-12-04 14:06:12,8,47,87,226,39,100,Amazon,data
2023-12-04 14:06:15,61,89,227,307,28,52,Youtube,data
2023-12-04 14:06:20,9,32,100,203,23,80,Bing,DDIO
2023-12-04 14:06:21,18,57,101,202,39,62,Amazon,DDIO
2023-12-04 14:06:23,59,108,266,360,49,45,Youtube,DDIO
2023-12-04 14:06:30,39,65,117,524,26,381,Bing,MSFG
2023-12-04 14:06:31,14,45,93,199,31,75,Amazon,MSFG
2023-12-04 14:06:34,80,111,255,337,31,51,Youtube,MSFG
2023-12-04 14:06:39,11,40,95,171,29,47,Bing,HOA
2023-12-04 14:06:40,9,38,79,191,29,83,Amazon,HOA
2023-12-04 14:06:43,77,136,276,358,59,23,Youtube,HOA
2023-12-04 14:06:47,12,60,125,201,48,28,Bing,FAFR
2023-12-04 14:06:49,19,56,100,210,37,73,Amazon,FAFR
2023-12-04 14:06:52,66,98,247,333,32,54,Youtube,FAFR
2023-12-04 14:06:56,9,35,84,195,26,85,Bing,WieSOichDichEmpfangen
2023-12-04 14:06:58,5,43,88,197,38,71,Amazon,WieSOichDichEmpfangen
2023-12-04 14:07:01,51,115,314,422,64,44,Youtube,WieSOichDichEmpfangen
2023-12-04 14:07:06,13,45,104,186,32,50,Bing,sagmichbitte
2023-12-04 14:07:07,5,34,75,178,29,74,Amazon,sagmichbitte
2023-12-04 14:07:10,79,112,258,339,33,48,Youtube,sagmichbitte
2023-12-04 14:07:15,10,37,77,158,27,54,Bing,ilAuraitSuffi
2023-12-04 14:07:16,6,43,84,200,37,79,Amazon,ilAuraitSuffi
2023-12-04 14:07:19,46,77,221,300,31,48,Youtube,ilAuraitSuffi
2023-12-04 14:07:33,8,40,79,168,32,57,Bing,Carnegie Mellon University
2023-12-04 14:07:35,9,39,79,188,30,79,Amazon,Carnegie Mellon University
2023-12-04 14:07:37,55,91,243,316,36,37,Youtube,Carnegie Mellon University
2023-12-04 14:07:41,7,34,75,141,27,39,Bing,Airbnb
2023-12-04 14:07:43,13,42,81,228,29,118,Amazon,Airbnb
2023-12-04 14:07:47,53,82,216,291,29,46,Youtube,Airbnb
2023-12-04 14:07:51,8,35,74,161,27,60,Bing,Facebook
2023-12-04 14:07:53,15,45,84,211,30,97,Amazon,Facebook
2023-12-04 14:07:56,59,91,239,328,32,57,Youtube,Facebook
2023-12-04 14:08:01,7,31,79,171,24,68,Bing,Youtube
2023-12-04 14:08:02,12,46,96,221,34,91,Amazon,Youtube
2023-12-04 14:08:04,53,90,263,343,37,43,Youtube,Youtube
2023-12-04 14:08:10,10,36,89,155,26,40,Bing,cirtic
2023-12-04 14:08:11,34,68,116,254,34,104,Amazon,cirtic
2023-12-04 14:08:15,106,139,301,384,33,50,Youtube,cirtic
2023-12-04 14:08:22,11,35,85,152,24,43,Bing,when would there be
2023-12-04 14:08:23,11,76,130,251,65,56,Amazon,when would there be
2023-12-04 14:08:26,55,84,221,307,29,57,Youtube,when would there be
2023-12-04 14:08:31,10,43,89,177,33,55,Bing,search the map for new
2023-12-04 14:08:32,6,74,117,230,68,45,Amazon,search the map for new
2023-12-04 14:08:35,53,84,219,292,31,42,Youtube,search the map for new
2023-12-04 14:08:40,8,48,108,173,40,25,Bing,suggestions on finals
2023-12-04 14:08:41,7,38,79,217,31,107,Amazon,suggestions on finals
2023-12-04 14:08:45,78,122,298,376,44,34,Youtube,suggestions on finals
2023-12-04 14:08:50,33,60,101,170,27,42,Bing,start
2023-12-04 14:08:51,7,38,80,179,31,68,Amazon,start
2023-12-04 14:08:55,71,106,268,356,35,53,Youtube,start
2023-12-04 14:08:59,9,35,87,175,26,62,Bing,ending
2023-12-04 14:09:01,6,39,78,185,33,74,Amazon,ending
2023-12-04 14:09:04,88,123,269,372,35,68,Youtube,ending
2023-12-04 14:09:08,8,36,73,144,28,43,Bing,safety
2023-12-04 14:09:10,4,34,75,177,30,72,Amazon,safety
2023-12-04 14:09:13,57,92,254,339,35,50,Youtube,safety
2023-12-04 14:09:17,31,57,102,196,26,68,Bing,data
2023-12-04 14:09:19,8,37,76,187,29,82,Amazon,data
2023-12-04 14:09:22,68,105,276,365,37,52,Youtube,data
2023-12-04 14:09:27,11,96,157,251,85,9,Bing,DDIO
2023-12-04 14:09:28,11,42,83,210,31,96,Amazon,DDIO
2023-12-04 14:09:32,88,123,270,365,35,60,Youtube,DDIO
2023-12-04 14:09:37,19,45,92,230,26,112,Bing,MSFG
2023-12-04 14:09:38,8,38,76,183,30,77,Amazon,MSFG
2023-12-04 14:09:42,94,133,320,416,39,57,Youtube,MSFG
2023-12-04 14:09:46,32,58,113,271,26,132,Bing,HOA
2023-12-04 14:09:48,56,86,124,244,30,90,Amazon,HOA
2023-12-04 14:09:51,99,148,336,416,49,31,Youtube,HOA
2023-12-04 14:09:57,34,62,114,183,28,41,Bing,FAFR
2023-12-04 14:09:58,26,57,101,233,31,101,Amazon,FAFR
2023-12-04 14:10:02,145,209,374,463,64,25,Youtube,FAFR
2023-12-04 14:10:07,14,40,94,173,26,53,Bing,WieSOichDichEmpfangen
2023-12-04 14:10:08,14,48,93,222,34,95,Amazon,WieSOichDichEmpfangen
2023-12-04 14:10:11,55,85,250,334,30,54,Youtube,WieSOichDichEmpfangen
2023-12-04 14:10:16,11,42,100,199,31,68,Bing,sagmichbitte
2023-12-04 14:10:18,12,46,105,249,34,110,Amazon,sagmichbitte
2023-12-04 14:10:20,72,115,292,367,43,32,Youtube,sagmichbitte
2023-12-04 14:10:25,18,110,173,291,92,26,Bing,ilAuraitSuffi
2023-12-04 14:10:26,22,55,106,211,33,72,Amazon,ilAuraitSuffi
2023-12-04 14:10:29,83,121,307,384,38,39,Youtube,ilAuraitSuffi
2023-12-04 14:10:44,10,34,82,171,24,65,Bing,Carnegie Mellon University
2023-12-04 14:10:46,10,43,82,183,33,68,Amazon,Carnegie Mellon University
2023-12-04 14:10:48,60,91,226,308,31,51,Youtube,Carnegie Mellon University
2023-12-04 14:10:52,27,51,92,162,24,46,Bing,Airbnb
2023-12-04 14:10:54,6,35,72,173,29,72,Amazon,Airbnb
2023-12-04 14:10:56,47,87,262,347,40,45,Youtube,Airbnb
2023-12-04 14:11:01,13,42,112,201,29,60,Bing,Facebook
2023-12-04 14:11:03,12,42,93,218,30,95,Amazon,Facebook
2023-12-04 14:11:05,64,96,244,335,32,59,Youtube,Facebook
2023-12-04 14:11:11,15,41,91,164,26,47,Bing,Youtube
2023-12-04 14:11:13,75,108,158,276,33,85,Amazon,Youtube
2023-12-04 14:11:17,104,135,312,433,31,90,Youtube,Youtube
2023-12-04 14:11:22,11,39,86,290,28,176,Bing,cirtic
2023-12-04 14:11:24,7,39,97,240,32,111,Amazon,cirtic
2023-12-04 14:11:27,95,153,396,478,58,24,Youtube,cirtic
2023-12-04 14:11:32,9,36,87,240,27,126,Bing,when would there be
2023-12-04 14:11:33,27,90,150,271,63,58,Amazon,when would there be
2023-12-04 14:11:37,80,118,339,427,38,50,Youtube,when would there be
2023-12-04 14:11:42,10,43,93,173,33,47,Bing,search the map for new
2023-12-04 14:11:44,7,35,76,175,28,71,Amazon,search the map for new
2023-12-04 14:11:48,72,112,342,423,40,41,Youtube,search the map for new
2023-12-04 14:11:53,19,44,99,172,25,48,Bing,suggestions on finals
2023-12-04 14:11:54,28,62,102,226,34,90,Amazon,suggestions on finals
2023-12-04 14:11:57,80,114,251,333,34,48,Youtube,suggestions on finals
2023-12-04 14:12:02,78,105,148,244,27,69,Bing,start
2023-12-04 14:12:04,17,46,86,204,29,89,Amazon,start
2023-12-04 14:12:07,88,121,273,355,33,49,Youtube,start
2023-12-04 14:12:12,12,42,122,196,30,44,Bing,ending
2023-12-04 14:12:14,5,46,87,192,41,64,Amazon,ending
2023-12-04 14:12:18,78,149,344,444,71,29,Youtube,ending
2023-12-04 14:12:26,34,60,103,197,26,68,Bing,safety
2023-12-04 14:12:28,11,44,79,194,33,82,Amazon,safety
2023-12-04 14:12:30,65,97,260,339,32,47,Youtube,safety
2023-12-04 14:12:35,11,36,85,267,25,157,Bing,data
2023-12-04 14:12:36,9,40,84,205,31,90,Amazon,data
2023-12-04 14:12:40,63,122,305,397,59,33,Youtube,data
2023-12-04 14:12:46,16,42,97,165,26,42,Bing,DDIO
2023-12-04 14:12:48,10,38,80,187,28,79,Amazon,DDIO
2023-12-04 14:12:50,92,127,269,348,35,44,Youtube,DDIO
2023-12-04 14:12:56,43,69,118,185,26,41,Bing,MSFG
2023-12-04 14:12:57,20,52,91,197,32,74,Amazon,MSFG
2023-12-04 14:13:01,101,127,263,336,26,47,Youtube,MSFG
2023-12-04 14:13:06,9,34,86,155,25,44,Bing,HOA
2023-12-04 14:13:07,20,51,95,252,31,126,Amazon,HOA
2023-12-04 14:13:10,68,109,337,493,41,115,Youtube,HOA
2023-12-04 14:13:16,14,51,102,176,37,37,Bing,FAFR
2023-12-04 14:13:17,14,56,101,206,42,63,Amazon,FAFR
2023-12-04 14:13:21,81,118,286,378,37,55,Youtube,FAFR
2023-12-04 14:13:27,100,124,175,247,24,48,Bing,WieSOichDichEmpfangen
2023-12-04 14:13:28,5,35,77,226,30,119,Amazon,WieSOichDichEmpfangen
2023-12-04 14:13:32,71,115,318,393,44,31,Youtube,WieSOichDichEmpfangen
2023-12-04 14:13:37,9,36,83,169,27,59,Bing,sagmichbitte
2023-12-04 14:13:39,5,33,73,204,28,103,Amazon,sagmichbitte
2023-12-04 14:13:41,58,95,253,348,37,58,Youtube,sagmichbitte
2023-12-04 14:13:46,10,36,82,376,26,268,Bing,ilAuraitSuffi
2023-12-04 14:13:47,58,89,129,243,31,83,Amazon,ilAuraitSuffi
2023-12-04 14:13:50,81,137,321,405,56,28,Youtube,ilAuraitSuffi
2023-12-04 14:14:05,11,49,104,234,38,92,Bing,Carnegie Mellon University
2023-12-04 14:14:07,8,39,86,231,31,114,Amazon,Carnegie Mellon University
2023-12-04 14:14:08,74,116,280,370,42,48,Youtube,Carnegie Mellon University
2023-12-04 14:14:13,7,32,74,143,25,44,Bing,Airbnb
2023-12-04 14:14:15,6,47,97,227,41,89,Amazon,Airbnb
2023-12-04 14:14:17,51,82,211,289,31,47,Youtube,Airbnb
2023-12-04 14:14:22,11,41,95,180,30,55,Bing,Facebook
2023-12-04 14:14:24,7,59,112,229,52,65,Amazon,Facebook
2023-12-04 14:14:28,69,104,297,386,35,54,Youtube,Facebook
2023-12-04 14:14:33,15,63,116,246,48,82,Bing,Youtube
2023-12-04 14:14:36,15,61,108,218,46,64,Amazon,Youtube
2023-12-04 14:14:40,108,142,407,505,34,64,Youtube,Youtube
2023-12-04 14:14:45,10,47,114,203,37,52,Bing,cirtic
2023-12-04 14:14:47,11,44,86,197,33,78,Amazon,cirtic
2023-12-04 14:14:49,96,132,307,388,36,45,Youtube,cirtic
2023-12-04 14:14:54,9,35,85,186,26,75,Bing,when would there be
2023-12-04 14:14:56,7,36,82,186,29,75,Amazon,when would there be
2023-12-04 14:14:58,87,127,362,440,40,38,Youtube,when would there be
2023-12-04 14:15:03,12,49,103,225,37,85,Bing,search the map for new
2023-12-04 14:15:05,15,53,110,233,38,85,Amazon,search the map for new
2023-12-04 14:15:07,71,125,285,360,54,21,Youtube,search the map for new
2023-12-04 14:15:13,15,49,101,178,34,43,Bing,suggestions on finals
2023-12-04 14:15:15,8,40,98,222,32,92,Amazon,suggestions on finals
2023-12-04 14:15:17,78,112,270,352,34,48,Youtube,suggestions on finals
2023-12-04 14:15:22,10,36,90,231,26,115,Bing,start
2023-12-04 14:15:24,15,45,89,205,30,86,Amazon,start
2023-12-04 14:15:28,83,126,283,363,43,37,Youtube,start
2023-12-04 14:15:33,8,201,258,565,193,114,Bing,ending
2023-12-04 14:15:35,7,42,87,194,35,72,Amazon,ending
2023-12-04 14:15:38,83,125,366,440,42,32,Youtube,ending
2023-12-04 14:15:43,13,75,153,423,62,208,Bing,safety
2023-12-04 14:15:44,13,45,87,187,32,68,Amazon,safety
2023-12-04 14:15:48,81,130,299,385,49,37,Youtube,safety
2023-12-04 14:15:53,10,35,113,261,25,123,Bing,data
2023-12-04 14:15:56,10,41,149,276,31,96,Amazon,data
2023-12-04 14:15:59,73,103,250,337,30,57,Youtube,data
2023-12-04 14:16:05,10,39,101,172,29,42,Bing,DDIO
2023-12-04 14:16:07,10,43,91,238,33,114,Amazon,DDIO
2023-12-04 14:16:10,58,88,238,310,30,42,Youtube,DDIO
2023-12-04 14:16:17,14,59,104,226,45,77,Amazon,MSFG
2023-12-04 14:16:21,95,136,296,394,41,57,Youtube,MSFG
2023-12-04 14:16:26,10,40,196,261,30,35,Bing,HOA
2023-12-04 14:16:28,54,83,124,238,29,85,Amazon,HOA
2023-12-04 14:16:32,67,99,256,330,32,42,Youtube,HOA
2023-12-04 14:16:38,11,50,95,201,39,67,Amazon,FAFR
2023-12-04 14:16:41,89,117,283,369,28,58,Youtube,FAFR
2023-12-04 14:16:46,10,41,107,175,31,37,Bing,WieSOichDichEmpfangen
2023-12-04 14:16:47,8,41,96,206,33,77,Amazon,WieSOichDichEmpfangen
2023-12-04 14:16:51,131,186,396,476,55,25,Youtube,WieSOichDichEmpfangen
2023-12-04 14:16:56,10,37,113,176,27,36,Bing,sagmichbitte
2023-12-04 14:16:57,9,44,89,232,35,108,Amazon,sagmichbitte
2023-12-04 14:17:01,111,167,349,440,56,35,Youtube,sagmichbitte
2023-12-04 14:17:06,11,36,107,199,25,67,Bing,ilAuraitSuffi
2023-12-04 14:17:07,25,65,108,223,40,75,Amazon,ilAuraitSuffi
2023-12-04 14:17:10,59,99,248,348,40,60,Youtube,ilAuraitSuffi
dateTime,connectStart,secureConnectionStart,requestStart,responseStart,networkTime,serverTime,service site,searching string
2023-12-04 14:04:42,11,38,85,183,27,71,Bing,Carnegie Mellon University
2023-12-04 14:04:43,5,34,75,197,29,93,Amazon,Carnegie Mellon University
2023-12-04 14:04:46,49,78,217,313,29,67,Youtube,Carnegie Mellon University
2023-12-04 14:04:51,55,82,129,202,27,46,Bing,Airbnb
2023-12-04 14:04:53,6,33,75,186,27,84,Amazon,Airbnb
2023-12-04 14:04:55,100,133,273,348,33,42,Youtube,Airbnb
2023-12-04 14:05:00,7,38,88,250,31,131,Bing,Facebook
2023-12-04 14:05:01,9,36,75,182,27,80,Amazon,Facebook
2023-12-04 14:05:05,73,124,283,362,51,28,Youtube,Facebook
2023-12-04 14:05:10,30,55,106,186,25,55,Bing,Youtube
2023-12-04 14:05:11,15,50,88,189,35,66,Amazon,Youtube
2023-12-04 14:05:13,66,101,258,351,35,58,Youtube,Youtube
2023-12-04 14:05:18,9,37,85,192,28,79,Bing,cirtic
2023-12-04 14:05:20,20,52,88,190,32,70,Amazon,cirtic
2023-12-04 14:05:23,73,109,272,349,36,41,Youtube,cirtic
2023-12-04 14:05:28,7,32,72,163,25,66,Bing,when would there be
2023-12-04 14:05:30,8,41,80,183,33,70,Amazon,when would there be
2023-12-04 14:05:35,47,130,567,736,83,86,Youtube,when would there be
2023-12-04 14:05:40,35,61,104,267,26,137,Bing,search the map for new
2023-12-04 14:05:41,7,35,73,184,28,83,Amazon,search the map for new
2023-12-04 14:05:44,114,143,286,367,29,52,Youtube,search the map for new
2023-12-04 14:05:49,11,40,99,172,29,44,Bing,suggestions on finals
2023-12-04 14:05:50,37,67,104,200,30,66,Amazon,suggestions on finals
2023-12-04 14:05:53,64,96,237,323,32,54,Youtube,suggestions on finals
2023-12-04 14:05:58,11,39,79,149,28,42,Bing,start
2023-12-04 14:06:00,15,45,81,186,30,75,Amazon,start
2023-12-04 14:06:02,53,87,225,303,34,44,Youtube,start
2023-12-04 14:06:07,7,34,77,150,27,46,Bing,ending
2023-12-04 14:06:09,8,36,72,177,28,77,Amazon,ending
2023-12-04 14:06:12,56,89,257,335,33,45,Youtube,ending
2023-12-04 14:06:17,9,33,76,169,24,69,Bing,safety
2023-12-04 14:06:20,11,40,79,179,29,71,Amazon,safety
2023-12-04 14:06:22,103,139,288,363,36,39,Youtube,safety
2023-12-04 14:06:28,15,62,112,190,47,31,Bing,data
2023-12-04 14:06:30,20,49,87,219,29,103,Amazon,data
2023-12-04 14:06:33,97,134,283,365,37,45,Youtube,data
2023-12-04 14:06:37,10,36,90,156,26,40,Bing,DDIO
2023-12-04 14:06:39,12,40,76,186,28,82,Amazon,DDIO
2023-12-04 14:06:42,59,103,249,324,44,31,Youtube,DDIO
2023-12-04 14:06:47,7,34,77,150,27,46,Bing,MSFG
2023-12-04 14:06:48,6,35,75,187,29,83,Amazon,MSFG
2023-12-04 14:06:52,75,146,294,379,71,14,Youtube,MSFG
2023-12-04 14:06:56,9,34,92,226,25,109,Bing,HOA
2023-12-04 14:06:58,7,37,76,190,30,84,Amazon,HOA
2023-12-04 14:07:01,86,120,360,440,34,46,Youtube,HOA
2023-12-04 14:07:05,31,58,104,178,27,47,Bing,FAFR
2023-12-04 14:07:07,64,98,146,255,34,75,Amazon,FAFR
2023-12-04 14:07:10,92,128,288,387,36,63,Youtube,FAFR
2023-12-04 14:07:15,7,31,72,186,24,90,Bing,WieSOichDichEmpfangen
2023-12-04 14:07:16,7,42,84,208,35,89,Amazon,WieSOichDichEmpfangen
2023-12-04 14:07:19,51,89,269,347,38,40,Youtube,WieSOichDichEmpfangen
2023-12-04 14:07:23,7,33,73,148,26,49,Bing,sagmichbitte
2023-12-04 14:07:24,4,42,88,223,38,97,Amazon,sagmichbitte
2023-12-04 14:07:26,39,69,210,305,30,65,Youtube,sagmichbitte
2023-12-04 14:07:30,59,115,158,246,56,32,Bing,ilAuraitSuffi
2023-12-04 14:07:31,5,33,67,172,28,77,Amazon,ilAuraitSuffi
2023-12-04 14:07:33,32,63,201,325,31,93,Youtube,ilAuraitSuffi
2023-12-04 14:07:48,7,33,72,149,26,51,Bing,Carnegie Mellon University
2023-12-04 14:07:49,7,37,76,187,30,81,Amazon,Carnegie Mellon University
2023-12-04 14:07:52,54,79,219,296,25,52,Youtube,Carnegie Mellon University
2023-12-04 14:07:57,8,39,393,460,31,36,Bing,Airbnb
2023-12-04 14:07:58,14,42,81,187,28,78,Amazon,Airbnb
2023-12-04 14:08:01,56,92,256,333,36,41,Youtube,Airbnb
2023-12-04 14:08:06,12,39,85,173,27,61,Bing,Facebook
2023-12-04 14:08:07,7,37,74,186,30,82,Amazon,Facebook
2023-12-04 14:08:10,73,107,247,323,34,42,Youtube,Facebook
2023-12-04 14:08:17,13,41,93,189,28,68,Bing,Youtube
2023-12-04 14:08:19,21,49,87,202,28,87,Amazon,Youtube
2023-12-04 14:08:28,9,35,75,141,26,40,Bing,cirtic
2023-12-04 14:08:29,42,71,111,244,29,104,Amazon,cirtic
2023-12-04 14:08:35,65,104,244,329,39,46,Youtube,cirtic
2023-12-04 14:08:39,8,36,79,178,28,71,Bing,when would there be
2023-12-04 14:08:41,5,34,72,188,29,87,Amazon,when would there be
2023-12-04 14:08:45,99,133,283,356,34,39,Youtube,when would there be
2023-12-04 14:08:50,8,33,86,189,25,78,Bing,search the map for new
2023-12-04 14:08:51,16,49,89,205,33,83,Amazon,search the map for new
2023-12-04 14:08:55,74,123,296,401,49,56,Youtube,search the map for new
2023-12-04 14:08:59,7,34,80,183,27,76,Bing,suggestions on finals
2023-12-04 14:09:01,12,44,84,193,32,77,Amazon,suggestions on finals
2023-12-04 14:09:04,68,99,293,386,31,62,Youtube,suggestions on finals
2023-12-04 14:09:09,10,56,110,185,46,29,Bing,start
2023-12-04 14:09:11,9,39,87,191,30,74,Amazon,start
2023-12-04 14:09:13,95,128,289,371,33,49,Youtube,start
2023-12-04 14:09:17,10,41,86,170,31,53,Bing,ending
2023-12-04 14:09:19,4,33,73,185,29,83,Amazon,ending
2023-12-04 14:09:22,62,92,253,321,30,38,Youtube,ending
2023-12-04 14:09:27,21,89,141,214,68,5,Bing,safety
2023-12-04 14:09:29,18,60,111,207,42,54,Amazon,safety
2023-12-04 14:09:33,97,127,278,376,30,68,Youtube,safety
2023-12-04 14:09:38,15,77,128,243,62,53,Bing,data
2023-12-04 14:09:40,40,68,109,220,28,83,Amazon,data
2023-12-04 14:09:42,57,86,227,318,29,62,Youtube,data
2023-12-04 14:09:47,11,42,157,253,31,65,Bing,DDIO
2023-12-04 14:09:49,21,54,100,214,33,81,Amazon,DDIO
2023-12-04 14:09:52,65,96,249,339,31,59,Youtube,DDIO
2023-12-04 14:09:58,11,46,103,187,35,49,Bing,MSFG
2023-12-04 14:09:59,7,46,104,214,39,71,Amazon,MSFG
2023-12-04 14:10:01,110,152,319,407,42,46,Youtube,MSFG
2023-12-04 14:10:06,10,36,83,153,26,44,Bing,HOA
2023-12-04 14:10:08,15,45,92,199,30,77,Amazon,HOA
2023-12-04 14:10:10,76,112,272,345,36,37,Youtube,HOA
2023-12-04 14:10:16,105,131,183,261,26,52,Bing,FAFR
2023-12-04 14:10:17,25,57,100,207,32,75,Amazon,FAFR
2023-12-04 14:10:19,131,183,365,448,52,31,Youtube,FAFR
2023-12-04 14:10:24,11,36,97,168,25,46,Bing,WieSOichDichEmpfangen
2023-12-04 14:10:25,6,45,93,226,39,94,Amazon,WieSOichDichEmpfangen
2023-12-04 14:10:29,51,90,271,351,39,41,Youtube,WieSOichDichEmpfangen
2023-12-04 14:10:34,8,32,76,168,24,68,Bing,sagmichbitte
2023-12-04 14:10:35,8,39,76,193,31,86,Amazon,sagmichbitte
2023-12-04 14:10:37,50,83,221,301,33,47,Youtube,sagmichbitte
2023-12-04 14:10:41,8,36,74,162,28,60,Bing,ilAuraitSuffi
2023-12-04 14:10:42,11,40,82,204,29,93,Amazon,ilAuraitSuffi
2023-12-04 14:10:45,55,85,221,305,30,54,Youtube,ilAuraitSuffi
2023-12-04 14:11:00,8,35,92,165,27,46,Bing,Carnegie Mellon University
2023-12-04 14:11:01,5,40,83,185,35,67,Amazon,Carnegie Mellon University
2023-12-04 14:11:05,79,118,339,443,39,65,Youtube,Carnegie Mellon University
2023-12-04 14:11:11,59,97,174,278,38,66,Bing,Airbnb
2023-12-04 14:11:13,22,56,107,229,34,88,Amazon,Airbnb
2023-12-04 14:11:17,89,125,310,403,36,57,Youtube,Airbnb
2023-12-04 14:11:22,13,55,103,189,42,44,Bing,Facebook
2023-12-04 14:11:24,12,41,84,183,29,70,Amazon,Facebook
2023-12-04 14:11:26,106,181,357,443,75,11,Youtube,Facebook
2023-12-04 14:11:31,34,65,114,183,31,38,Bing,Youtube
2023-12-04 14:11:33,7,36,78,178,29,71,Amazon,Youtube
2023-12-04 14:11:37,89,121,349,430,32,49,Youtube,Youtube
2023-12-04 14:11:42,15,42,92,200,27,81,Bing,cirtic
2023-12-04 14:11:44,15,46,96,233,31,106,Amazon,cirtic
2023-12-04 14:11:46,146,216,409,520,70,41,Youtube,cirtic
2023-12-04 14:11:52,11,37,87,201,26,88,Bing,when would there be
2023-12-04 14:11:53,7,40,90,233,33,110,Amazon,when would there be
2023-12-04 14:11:57,98,134,279,365,36,50,Youtube,when would there be
2023-12-04 14:12:02,12,47,96,250,35,119,Bing,search the map for new
2023-12-04 14:12:04,14,46,99,256,32,125,Amazon,search the map for new
2023-12-04 14:12:07,101,135,306,395,34,55,Youtube,search the map for new
2023-12-04 14:12:12,12,43,102,196,31,63,Bing,suggestions on finals
2023-12-04 14:12:14,16,44,84,201,28,89,Amazon,suggestions on finals
2023-12-04 14:12:18,113,172,343,450,59,48,Youtube,suggestions on finals
2023-12-04 14:12:26,12,39,81,161,27,53,Bing,start
2023-12-04 14:12:28,5,35,72,187,30,85,Amazon,start
2023-12-04 14:12:31,60,89,244,332,29,59,Youtube,start
2023-12-04 14:12:36,9,39,112,220,30,78,Bing,ending
2023-12-04 14:12:37,7,37,78,201,30,93,Amazon,ending
2023-12-04 14:12:40,67,114,269,348,47,32,Youtube,ending
2023-12-04 14:12:45,18,60,112,195,42,41,Bing,safety
2023-12-04 14:12:48,11,40,85,191,29,77,Amazon,safety
2023-12-04 14:12:51,78,107,283,375,29,63,Youtube,safety
2023-12-04 14:12:56,13,43,93,163,30,40,Bing,data
2023-12-04 14:12:59,24,58,105,238,34,99,Amazon,data
2023-12-04 14:13:01,59,102,270,361,43,48,Youtube,data
2023-12-04 14:13:06,10,36,85,197,26,86,Bing,DDIO
2023-12-04 14:13:08,14,52,106,211,38,67,Amazon,DDIO
2023-12-04 14:13:12,160,213,382,457,53,22,Youtube,DDIO
2023-12-04 14:13:18,35,61,113,192,26,53,Bing,MSFG
2023-12-04 14:13:19,10,77,124,231,67,40,Amazon,MSFG
2023-12-04 14:13:22,81,115,277,366,34,55,Youtube,MSFG
2023-12-04 14:13:29,10,65,119,230,55,56,Amazon,HOA
2023-12-04 14:13:33,87,119,259,334,32,43,Youtube,HOA
2023-12-04 14:13:37,11,47,100,183,36,47,Bing,FAFR
2023-12-04 14:13:39,5,36,83,179,31,65,Amazon,FAFR
2023-12-04 14:13:42,115,171,336,429,56,37,Youtube,FAFR
2023-12-04 14:13:47,8,37,83,154,29,42,Bing,WieSOichDichEmpfangen
2023-12-04 14:13:48,15,54,103,212,39,70,Amazon,WieSOichDichEmpfangen
2023-12-04 14:13:50,64,98,300,381,34,47,Youtube,WieSOichDichEmpfangen
2023-12-04 14:13:55,8,32,78,160,24,58,Bing,sagmichbitte
2023-12-04 14:13:56,4,33,72,198,29,97,Amazon,sagmichbitte
2023-12-04 14:13:58,54,91,230,310,37,43,Youtube,sagmichbitte
2023-12-04 14:14:03,34,63,105,229,29,95,Bing,ilAuraitSuffi
2023-12-04 14:14:04,5,41,90,205,36,79,Amazon,ilAuraitSuffi
2023-12-04 14:14:06,50,82,234,333,32,67,Youtube,ilAuraitSuffi
2023-12-04 14:14:21,8,35,81,193,27,85,Bing,Carnegie Mellon University
2023-12-04 14:14:24,28,55,97,202,27,78,Amazon,Carnegie Mellon University
2023-12-04 14:14:27,69,106,294,378,37,47,Youtube,Carnegie Mellon University
2023-12-04 14:14:33,106,131,201,484,25,258,Bing,Airbnb
2023-12-04 14:14:35,22,63,110,224,41,73,Amazon,Airbnb
2023-12-04 14:14:39,90,135,296,393,45,52,Youtube,Airbnb
2023-12-04 14:14:45,65,93,155,279,28,96,Bing,Facebook
2023-12-04 14:14:47,8,58,96,208,50,62,Amazon,Facebook
2023-12-04 14:14:49,92,126,287,380,34,59,Youtube,Facebook
2023-12-04 14:14:54,11,75,144,237,64,29,Bing,Youtube
2023-12-04 14:14:55,7,38,88,210,31,91,Amazon,Youtube
2023-12-04 14:14:58,113,150,328,408,37,43,Youtube,Youtube
2023-12-04 14:15:02,9,35,88,179,26,65,Bing,cirtic
2023-12-04 14:15:04,33,74,119,259,41,99,Amazon,cirtic
2023-12-04 14:15:07,175,211,394,505,36,75,Youtube,cirtic
2023-12-04 14:15:12,14,58,403,500,44,53,Bing,when would there be
2023-12-04 14:15:14,11,41,79,188,30,79,Amazon,when would there be
2023-12-04 14:15:16,67,136,308,401,69,24,Youtube,when would there be
2023-12-04 14:15:22,15,60,116,484,45,323,Bing,search the map for new
2023-12-04 14:15:23,8,40,81,190,32,77,Amazon,search the map for new
2023-12-04 14:15:27,58,89,280,364,31,53,Youtube,search the map for new
2023-12-04 14:15:32,10,39,183,336,29,124,Bing,suggestions on finals
2023-12-04 14:15:34,10,164,336,507,154,17,Amazon,suggestions on finals
2023-12-04 14:15:37,68,113,315,405,45,45,Youtube,suggestions on finals
2023-12-04 14:15:42,31,56,106,298,25,167,Bing,start
2023-12-04 14:15:44,16,69,163,319,53,103,Amazon,start
2023-12-04 14:15:47,79,116,300,378,37,41,Youtube,start
2023-12-04 14:15:52,12,55,105,181,43,33,Bing,ending
2023-12-04 14:15:54,12,43,90,198,31,77,Amazon,ending
2023-12-04 14:15:58,77,123,266,332,46,20,Youtube,ending
2023-12-04 14:16:03,38,67,134,198,29,35,Bing,safety
2023-12-04 14:16:06,11,43,86,193,32,75,Amazon,safety
2023-12-04 14:16:09,82,119,265,355,37,53,Youtube,safety
2023-12-04 14:16:14,9,36,101,177,27,49,Bing,data
2023-12-04 14:16:17,23,54,93,195,31,71,Amazon,data
2023-12-04 14:16:21,119,147,305,378,28,45,Youtube,data
2023-12-04 14:16:28,66,96,148,270,30,92,Amazon,DDIO
2023-12-04 14:16:32,77,113,295,379,36,48,Youtube,DDIO
2023-12-04 14:16:37,11,44,112,177,33,32,Bing,MSFG
2023-12-04 14:16:39,20,55,108,216,35,73,Amazon,MSFG
2023-12-04 14:16:41,101,136,293,373,35,45,Youtube,MSFG
2023-12-04 14:16:46,10,39,110,172,29,33,Bing,HOA
2023-12-04 14:16:47,20,49,90,196,29,77,Amazon,HOA
2023-12-04 14:16:50,78,131,298,385,53,34,Youtube,HOA
2023-12-04 14:16:55,9,37,102,176,28,46,Bing,FAFR
2023-12-04 14:16:57,7,42,87,218,35,96,Amazon,FAFR
2023-12-04 14:17:00,100,138,297,380,38,45,Youtube,FAFR
2023-12-04 14:17:05,13,41,134,202,28,40,Bing,WieSOichDichEmpfangen
2023-12-04 14:17:06,7,44,92,225,37,96,Amazon,WieSOichDichEmpfangen
2023-12-04 14:17:09,73,119,301,375,46,28,Youtube,WieSOichDichEmpfangen
2023-12-04 14:17:14,9,35,103,177,26,48,Bing,sagmichbitte
2023-12-04 14:17:15,4,35,73,186,31,82,Amazon,sagmichbitte
2023-12-04 14:17:17,45,78,219,299,33,47,Youtube,sagmichbitte
2023-12-04 14:17:21,40,65,125,191,25,41,Bing,ilAuraitSuffi
2023-12-04 14:17:22,9,38,74,182,29,79,Amazon,ilAuraitSuffi
2023-12-04 14:17:24,67,97,231,326,30,65,Youtube,ilAuraitSuffi
2023-12-04 14:17:38,7,33,93,159,26,40,Bing,Carnegie Mellon University
2023-12-04 14:17:40,5,35,73,195,30,92,Amazon,Carnegie Mellon University
2023-12-04 14:17:42,60,100,270,341,40,31,Youtube,Carnegie Mellon University
2023-12-04 14:17:46,7,35,98,165,28,39,Bing,Airbnb
2023-12-04 14:17:48,133,160,197,326,27,102,Amazon,Airbnb
2023-12-04 14:17:50,62,96,256,341,34,51,Youtube,Airbnb
2023-12-04 14:17:55,8,41,101,165,33,31,Bing,Facebook
2023-12-04 14:17:57,8,38,74,194,30,90,Amazon,Facebook
2023-12-04 14:17:59,51,82,227,311,31,53,Youtube,Facebook
2023-12-04 14:18:03,7,34,96,161,27,38,Bing,Youtube
2023-12-04 14:18:04,7,43,84,223,36,103,Amazon,Youtube
2023-12-04 14:18:06,52,95,257,328,43,28,Youtube,Youtube
2023-12-04 14:18:10,8,71,223,326,63,40,Bing,cirtic
2023-12-04 14:18:12,10,40,76,186,30,80,Amazon,cirtic
2023-12-04 14:18:14,52,84,215,286,32,39,Youtube,cirtic
2023-12-04 14:18:18,7,35,92,159,28,39,Bing,when would there be
2023-12-04 14:18:19,9,37,73,193,28,92,Amazon,when would there be
2023-12-04 14:18:21,55,85,216,294,30,48,Youtube,when would there be
2023-12-04 14:18:26,6,34,102,170,28,40,Bing,search the map for new
2023-12-04 14:18:27,8,41,78,176,33,65,Amazon,search the map for new
2023-12-04 14:18:30,55,86,248,327,31,48,Youtube,search the map for new
2023-12-04 14:18:35,8,35,109,174,27,38,Bing,suggestions on finals
2023-12-04 14:18:36,11,43,112,235,32,91,Amazon,suggestions on finals
2023-12-04 14:18:38,54,85,324,403,31,48,Youtube,suggestions on finals
2023-12-04 14:18:42,29,54,97,167,25,45,Bing,start
2023-12-04 14:18:44,4,39,82,186,35,69,Amazon,start
2023-12-04 14:18:47,60,89,227,304,29,48,Youtube,start
2023-12-04 14:18:50,7,33,81,244,26,137,Bing,ending
2023-12-04 14:18:52,5,35,72,194,30,92,Amazon,ending
2023-12-04 14:18:54,61,96,257,337,35,45,Youtube,ending
2023-12-04 14:18:58,7,32,74,277,25,178,Bing,safety
2023-12-04 14:19:00,4,40,86,188,36,66,Amazon,safety
2023-12-04 14:19:02,66,99,285,364,33,46,Youtube,safety
2023-12-04 14:19:09,7,33,84,159,26,49,Bing,data
2023-12-04 14:19:11,77,109,146,262,32,84,Amazon,data
2023-12-04 14:19:15,51,86,231,305,35,39,Youtube,data
2023-12-04 14:19:19,6,30,72,168,24,72,Bing,DDIO
2023-12-04 14:19:20,15,51,92,192,36,64,Amazon,DDIO
2023-12-04 14:19:23,54,92,272,345,38,35,Youtube,DDIO
2023-12-04 14:19:27,46,74,114,258,28,116,Bing,MSFG
2023-12-04 14:19:28,7,37,73,174,30,71,Amazon,MSFG
2023-12-04 14:19:30,43,74,210,286,31,45,Youtube,MSFG
2023-12-04 14:19:34,9,36,79,223,27,117,Bing,HOA
2023-12-04 14:19:35,14,42,81,182,28,73,Amazon,HOA
2023-12-04 14:19:38,54,93,238,325,39,48,Youtube,HOA
2023-12-04 14:19:42,4,37,77,148,33,38,Bing,FAFR
2023-12-04 14:19:43,4,34,70,175,30,75,Amazon,FAFR
2023-12-04 14:19:46,53,84,220,294,31,43,Youtube,FAFR
2023-12-04 14:19:50,7,33,74,147,26,47,Bing,WieSOichDichEmpfangen
2023-12-04 14:19:51,8,40,109,209,32,68,Amazon,WieSOichDichEmpfangen
2023-12-04 14:19:53,51,81,229,305,30,46,Youtube,WieSOichDichEmpfangen
2023-12-04 14:19:58,47,75,116,216,28,72,Bing,sagmichbitte
2023-12-04 14:19:59,7,34,70,176,27,79,Amazon,sagmichbitte
2023-12-04 14:20:01,45,78,219,289,33,37,Youtube,sagmichbitte
2023-12-04 14:20:05,7,35,74,144,28,42,Bing,ilAuraitSuffi
2023-12-04 14:20:06,4,31,68,190,27,95,Amazon,ilAuraitSuffi
2023-12-04 14:20:08,43,125,262,350,82,6,Youtube,ilAuraitSuffi
