dateTime,connectStart,secureConnectionStart,requestStart,responseStart,networkTime,serverTime,service site,searching string
2023-12-04 22:18:20,222,380,555,778,158,65,Bing,Carnegie Mellon University
2023-12-04 22:18:24,324,495,675,1026,171,180,Amazon,Carnegie Mellon University
2023-12-04 22:18:29,191,346,732,935,155,48,Youtube,Carnegie Mellon University
2023-12-04 22:18:34,14,171,429,656,157,70,Bing,Airbnb
2023-12-04 22:18:38,3,170,342,691,167,182,Amazon,Airbnb
2023-12-04 22:18:43,49,205,589,783,156,38,Youtube,Airbnb
2023-12-04 22:18:47,7,166,337,590,159,94,Bing,Facebook
2023-12-04 22:18:50,14,177,351,685,163,171,Amazon,Facebook
2023-12-04 22:18:55,43,202,743,949,159,47,Youtube,Facebook
2023-12-04 22:19:00,6,172,345,573,166,62,Bing,Youtube
2023-12-04 22:19:03,5,170,343,696,165,188,Amazon,Youtube
2023-12-04 22:19:07,48,202,774,975,154,47,Youtube,Youtube
2023-12-04 22:19:12,7,165,337,563,158,68,Bing,cirtic
2023-12-04 22:19:15,7,172,343,681,165,173,Amazon,cirtic
2023-12-04 22:19:20,177,341,888,1117,164,65,Youtube,cirtic
2023-12-04 22:19:25,162,319,499,734,157,78,Bing,when would there be
2023-12-04 22:19:28,10,172,348,685,162,175,Amazon,when would there be
2023-12-04 22:19:35,39,204,759,954,165,30,Youtube,when would there be
2023-12-04 22:19:40,349,512,692,921,163,66,Bing,search the map for new
2023-12-04 22:19:45,257,422,675,1010,165,170,Amazon,search the map for new
2023-12-04 22:19:52,38,223,1129,1352,185,38,Youtube,search the map for new
2023-12-04 22:19:56,7,163,334,562,156,72,Bing,suggestions on finals
2023-12-04 22:20:00,8,173,345,686,165,176,Amazon,suggestions on finals
2023-12-04 22:20:13,450,660,878,1254,210,166,Bing,start
2023-12-04 22:20:18,5,262,506,1105,257,342,Amazon,start
2023-12-04 22:20:22,56,56,1178,1373,0,195,Youtube,start
2023-12-04 22:20:27,6,162,335,564,156,73,Bing,ending
2023-12-04 22:20:30,8,171,345,688,163,180,Amazon,ending
2023-12-04 22:20:38,50,210,958,1171,160,53,Youtube,ending
2023-12-04 22:20:48,6,235,410,748,229,109,Amazon,safety
2023-12-04 22:21:00,332,491,657,874,159,58,Bing,data
2023-12-04 22:21:06,427,589,824,1178,162,192,Amazon,data
2023-12-04 22:21:11,56,298,771,1181,242,168,Youtube,data
2023-12-04 22:21:16,6,163,549,765,157,59,Bing,DDIO
2023-12-04 22:21:19,9,174,345,976,165,466,Amazon,DDIO
2023-12-04 22:21:26,47,204,1055,1292,157,80,Youtube,DDIO
2023-12-04 22:21:32,251,410,761,975,159,55,Bing,MSFG
2023-12-04 22:21:35,5,172,350,679,167,162,Amazon,MSFG
2023-12-04 22:21:46,9,164,334,558,155,69,Bing,HOA
2023-12-04 22:21:49,7,169,341,676,162,173,Amazon,HOA
2023-12-04 22:21:53,51,208,752,954,157,45,Youtube,HOA
2023-12-04 22:21:58,7,166,336,558,159,63,Bing,FAFR
2023-12-04 22:22:01,6,166,338,675,160,177,Amazon,FAFR
2023-12-04 22:22:06,40,198,781,976,158,37,Youtube,FAFR
2023-12-04 22:22:11,7,160,333,550,153,64,Bing,WieSOichDichEmpfangen
2023-12-04 22:22:14,5,166,341,671,161,169,Amazon,WieSOichDichEmpfangen
2023-12-04 22:22:21,38,195,727,928,157,44,Youtube,WieSOichDichEmpfangen
2023-12-04 22:22:25,265,427,690,919,162,67,Bing,sagmichbitte
2023-12-04 22:22:29,217,382,566,1017,165,286,Amazon,sagmichbitte
2023-12-04 22:22:45,4,390,772,1282,386,124,Amazon,ilAuraitSuffi
2023-12-04 22:22:51,26,186,985,1186,160,41,Youtube,ilAuraitSuffi
2023-12-04 22:23:06,162,319,499,736,157,80,Bing,Carnegie Mellon University
2023-12-04 22:23:10,4,168,340,679,164,175,Amazon,Carnegie Mellon University
2023-12-04 22:23:15,58,225,605,801,167,29,Youtube,Carnegie Mellon University
2023-12-04 22:23:20,7,168,345,578,161,72,Bing,Airbnb
2023-12-04 22:23:23,6,173,342,671,167,162,Amazon,Airbnb
2023-12-04 22:23:27,43,200,576,780,157,47,Youtube,Airbnb
2023-12-04 22:23:32,7,161,339,562,154,69,Bing,Facebook
2023-12-04 22:23:35,10,173,344,673,163,166,Amazon,Facebook
2023-12-04 22:23:39,41,197,731,932,156,45,Youtube,Facebook
2023-12-04 22:23:44,257,413,584,809,156,69,Bing,Youtube
2023-12-04 22:23:47,215,376,545,871,161,165,Amazon,Youtube
2023-12-04 22:23:51,51,208,583,787,157,47,Youtube,Youtube
2023-12-04 22:23:56,6,200,388,649,194,67,Bing,cirtic
2023-12-04 22:23:59,6,210,384,752,204,164,Amazon,cirtic
2023-12-04 22:24:04,44,243,1057,1274,199,18,Youtube,cirtic
2023-12-04 22:24:08,7,170,347,583,163,73,Bing,when would there be
2023-12-04 22:24:11,6,167,336,668,161,171,Amazon,when would there be
2023-12-04 22:24:16,47,209,744,952,162,46,Youtube,when would there be
2023-12-04 22:24:21,142,297,470,998,155,373,Bing,search the map for new
2023-12-04 22:24:26,5,5,920,1463,0,543,Amazon,search the map for new
2023-12-04 22:24:33,42,222,929,1126,180,17,Youtube,search the map for new
2023-12-04 22:24:37,223,382,557,880,159,164,Bing,suggestions on finals
2023-12-04 22:24:41,13,276,478,822,263,81,Amazon,suggestions on finals
2023-12-04 22:24:46,47,205,971,1223,158,94,Youtube,suggestions on finals
2023-12-04 22:24:50,6,165,337,583,159,87,Bing,start
2023-12-04 22:24:53,6,167,336,664,161,167,Amazon,start
2023-12-04 22:24:58,44,201,788,999,157,54,Youtube,start
2023-12-04 22:25:02,264,420,596,815,156,63,Bing,ending
2023-12-04 22:25:08,200,361,531,895,161,203,Amazon,ending
2023-12-04 22:25:16,43,200,983,1184,157,44,Youtube,ending
2023-12-04 22:25:23,7,302,1935,2286,295,56,Bing,safety
2023-12-04 22:25:28,9,187,458,833,178,197,Amazon,safety
2023-12-04 22:25:34,61,394,831,1291,333,127,Youtube,safety
2023-12-04 22:25:45,7,192,362,975,185,428,Amazon,data
2023-12-04 22:25:51,57,226,736,951,169,46,Youtube,data
2023-12-04 22:25:56,190,383,592,866,193,81,Bing,DDIO
2023-12-04 22:26:01,11,173,377,937,162,398,Amazon,DDIO
2023-12-04 22:26:06,41,198,948,1155,157,50,Youtube,DDIO
2023-12-04 22:26:11,7,173,386,612,166,60,Bing,MSFG
2023-12-04 22:26:14,7,167,342,679,160,177,Amazon,MSFG
2023-12-04 22:26:27,282,440,633,1089,158,298,Bing,HOA
2023-12-04 22:26:32,203,368,550,1202,165,487,Amazon,HOA
2023-12-04 22:26:38,46,208,753,1011,162,96,Youtube,HOA
2023-12-04 22:26:48,7,164,362,702,157,183,Amazon,FAFR
2023-12-04 22:26:53,44,204,975,1187,160,52,Youtube,FAFR
2023-12-04 22:26:58,159,315,494,718,156,68,Bing,WieSOichDichEmpfangen
2023-12-04 22:27:00,4,168,341,667,164,162,Amazon,WieSOichDichEmpfangen
2023-12-04 22:27:06,35,188,938,1140,153,49,Youtube,WieSOichDichEmpfangen
2023-12-04 22:27:10,7,166,339,563,159,65,Bing,sagmichbitte
2023-12-04 22:27:13,5,167,343,673,162,168,Amazon,sagmichbitte
2023-12-04 22:27:22,35,191,1015,1536,156,365,Youtube,sagmichbitte
2023-12-04 22:27:26,196,350,658,886,154,74,Bing,ilAuraitSuffi
2023-12-04 22:27:30,8,237,412,890,229,249,Amazon,ilAuraitSuffi
2023-12-04 22:27:36,34,190,999,1228,156,73,Youtube,ilAuraitSuffi
2023-12-04 22:27:52,223,384,555,1004,161,288,Bing,Carnegie Mellon University
2023-12-04 22:27:55,267,427,597,1022,160,265,Amazon,Carnegie Mellon University
2023-12-04 22:28:10,5,170,340,961,165,456,Amazon,Airbnb
2023-12-04 22:28:15,55,209,588,899,154,157,Youtube,Airbnb
2023-12-04 22:28:19,163,317,507,739,154,78,Bing,Facebook
2023-12-04 22:28:22,5,169,342,892,164,386,Amazon,Facebook
2023-12-04 22:28:27,49,205,746,944,156,42,Youtube,Facebook
2023-12-04 22:28:32,7,160,354,578,153,71,Bing,Youtube
2023-12-04 22:28:35,7,166,335,980,159,486,Amazon,Youtube
2023-12-04 22:28:39,46,202,579,804,156,69,Youtube,Youtube
2023-12-04 22:28:43,6,166,333,563,160,70,Bing,cirtic
2023-12-04 22:28:47,5,165,342,674,160,172,Amazon,cirtic
2023-12-04 22:28:52,37,192,742,963,155,66,Youtube,cirtic
2023-12-04 22:28:57,419,575,975,1464,156,333,Bing,when would there be
2023-12-04 22:29:02,9,182,468,980,173,339,Amazon,when would there be
2023-12-04 22:29:09,40,198,761,1181,158,262,Youtube,when would there be
2023-12-04 22:29:17,215,379,635,1018,164,219,Amazon,search the map for new
2023-12-04 22:29:25,37,195,1146,1451,158,147,Youtube,search the map for new
2023-12-04 22:29:30,156,311,671,915,155,89,Bing,suggestions on finals
2023-12-04 22:29:34,14,176,351,689,162,176,Amazon,suggestions on finals
2023-12-04 22:29:39,41,199,1005,1232,158,69,Youtube,suggestions on finals
2023-12-04 22:29:43,6,161,331,556,155,70,Bing,start
2023-12-04 22:29:47,5,166,426,940,161,353,Amazon,start
2023-12-04 22:29:55,44,44,1256,1456,0,200,Youtube,start
2023-12-04 22:30:04,5,188,368,813,183,262,Amazon,ending
2023-12-04 22:30:09,44,201,742,940,157,41,Youtube,ending
2023-12-04 22:30:13,7,163,330,562,156,76,Bing,safety
2023-12-04 22:30:18,8,170,341,674,162,171,Amazon,safety
2023-12-04 22:30:23,50,210,587,784,160,37,Youtube,safety
2023-12-04 22:30:29,267,450,1037,1387,183,167,Bing,data
2023-12-04 22:30:35,6,233,598,1103,227,278,Amazon,data
2023-12-04 22:30:47,244,403,611,838,159,68,Bing,DDIO
2023-12-04 22:30:50,6,168,339,682,162,181,Amazon,DDIO
2023-12-04 22:30:57,56,212,1093,1493,156,244,Youtube,DDIO
2023-12-04 22:31:06,4,214,388,737,210,139,Amazon,MSFG
2023-12-04 22:31:10,39,193,736,987,154,97,Youtube,MSFG
2023-12-04 22:31:19,5,355,529,1067,350,188,Amazon,HOA
2023-12-04 22:31:35,5,262,436,1031,257,338,Amazon,FAFR
2023-12-04 22:31:44,48,206,995,1218,158,65,Youtube,FAFR
2023-12-04 22:31:49,272,494,669,893,222,2,Bing,WieSOichDichEmpfangen
2023-12-04 22:31:53,5,167,343,1109,162,604,Amazon,WieSOichDichEmpfangen
2023-12-04 22:32:01,56,56,1135,1378,0,243,Youtube,WieSOichDichEmpfangen
2023-12-04 22:32:06,664,842,1073,1301,178,50,Bing,sagmichbitte
2023-12-04 22:32:09,8,168,344,675,160,171,Amazon,sagmichbitte
2023-12-04 22:32:14,34,192,968,1181,158,55,Youtube,sagmichbitte
2023-12-04 22:32:19,7,164,445,674,157,72,Bing,ilAuraitSuffi
2023-12-04 22:32:24,5,166,480,998,161,357,Amazon,ilAuraitSuffi
2023-12-04 22:32:31,24,181,1214,1532,157,161,Youtube,ilAuraitSuffi
