dateTime,connectStart,secureConnectionStart,requestStart,responseStart,networkTime,serverTime,service site,searching string
2023-12-04 21:48:40,121,260,413,618,139,66,Bing,Carnegie Mellon University
2023-12-04 21:48:43,205,309,421,681,104,156,Amazon,Carnegie Mellon University
2023-12-04 21:48:47,138,237,704,843,99,40,Youtube,Carnegie Mellon University
2023-12-04 21:48:51,6,135,287,501,129,85,Bing,Airbnb
2023-12-04 21:48:53,6,109,221,479,103,155,Amazon,Airbnb
2023-12-04 21:48:57,41,146,514,649,105,30,Youtube,Airbnb
2023-12-04 21:49:02,7,143,302,512,136,74,Bing,Facebook
2023-12-04 21:49:05,9,109,218,478,100,160,Amazon,Facebook
2023-12-04 21:49:09,169,277,540,674,108,26,Youtube,Facebook
2023-12-04 21:49:15,1222,1375,1569,1803,153,81,Bing,Youtube
2023-12-04 21:49:17,16,118,225,478,102,151,Amazon,Youtube
2023-12-04 21:49:21,44,150,415,574,106,53,Youtube,Youtube
2023-12-04 21:49:25,11,163,319,526,152,55,Bing,cirtic
2023-12-04 21:49:27,5,106,219,493,101,173,Amazon,cirtic
2023-12-04 21:49:31,42,151,530,685,109,46,Youtube,cirtic
2023-12-04 21:49:36,9,143,296,506,134,76,Bing,when would there be
2023-12-04 21:49:39,6,109,219,488,103,166,Amazon,when would there be
2023-12-04 21:49:42,44,151,527,672,107,38,Youtube,when would there be
2023-12-04 21:49:47,104,241,397,609,137,75,Bing,search the map for new
2023-12-04 21:49:50,9,111,220,655,102,333,Amazon,search the map for new
2023-12-04 21:49:53,76,188,593,729,112,24,Youtube,search the map for new
2023-12-04 21:49:58,120,249,392,599,129,78,Bing,suggestions on finals
2023-12-04 21:50:00,129,228,337,626,99,190,Amazon,suggestions on finals
2023-12-04 21:50:03,42,149,525,682,107,50,Youtube,suggestions on finals
2023-12-04 21:50:08,8,142,302,513,134,77,Bing,start
2023-12-04 21:50:10,5,113,222,478,108,148,Amazon,start
2023-12-04 21:50:15,55,157,537,694,102,55,Youtube,start
2023-12-04 21:50:20,7,141,280,493,134,79,Bing,ending
2023-12-04 21:50:22,9,110,220,479,101,158,Amazon,ending
2023-12-04 21:50:26,52,163,546,697,111,40,Youtube,ending
2023-12-04 21:50:30,123,257,410,639,134,95,Bing,safety
2023-12-04 21:50:33,6,111,219,482,105,158,Amazon,safety
2023-12-04 21:50:36,61,173,442,594,112,40,Youtube,safety
2023-12-04 21:50:41,7,143,291,503,136,76,Bing,data
2023-12-04 21:50:44,10,110,222,473,100,151,Amazon,data
2023-12-04 21:50:47,64,174,439,589,110,40,Youtube,data
2023-12-04 21:50:52,7,142,297,504,135,72,Bing,DDIO
2023-12-04 21:50:54,7,106,216,757,99,442,Amazon,DDIO
2023-12-04 21:50:57,41,150,526,677,109,42,Youtube,DDIO
2023-12-04 21:51:01,7,135,289,483,128,66,Bing,MSFG
2023-12-04 21:51:03,9,110,218,478,101,159,Amazon,MSFG
2023-12-04 21:51:07,46,156,537,698,110,51,Youtube,MSFG
2023-12-04 21:51:12,6,133,276,498,127,95,Bing,HOA
2023-12-04 21:51:14,7,108,220,475,101,154,Amazon,HOA
2023-12-04 21:51:20,53,53,1438,1635,0,197,Youtube,HOA
2023-12-04 21:51:25,120,254,404,624,134,86,Bing,FAFR
2023-12-04 21:51:27,265,369,486,746,104,156,Amazon,FAFR
2023-12-04 21:51:31,44,153,526,682,109,47,Youtube,FAFR
2023-12-04 21:51:35,6,135,282,491,129,80,Bing,WieSOichDichEmpfangen
2023-12-04 21:51:37,4,112,223,502,108,171,Amazon,WieSOichDichEmpfangen
2023-12-04 21:51:40,43,149,520,673,106,47,Youtube,WieSOichDichEmpfangen
2023-12-04 21:51:44,6,144,299,507,138,70,Bing,sagmichbitte
2023-12-04 21:51:46,4,106,227,515,102,186,Amazon,sagmichbitte
2023-12-04 21:51:50,52,157,523,663,105,35,Youtube,sagmichbitte
2023-12-04 21:51:55,98,233,382,596,135,79,Bing,ilAuraitSuffi
2023-12-04 21:51:56,4,104,212,473,100,161,Amazon,ilAuraitSuffi
2023-12-04 21:52:01,28,134,515,697,106,76,Youtube,ilAuraitSuffi
2023-12-04 21:52:15,6,138,282,506,132,92,Bing,Carnegie Mellon University
2023-12-04 21:52:19,4,105,218,485,101,166,Amazon,Carnegie Mellon University
2023-12-04 21:52:22,48,156,423,568,108,37,Youtube,Carnegie Mellon University
2023-12-04 21:52:26,112,238,379,576,126,71,Bing,Airbnb
2023-12-04 21:52:29,6,109,225,491,103,163,Amazon,Airbnb
2023-12-04 21:52:33,42,150,418,572,108,46,Youtube,Airbnb
2023-12-04 21:52:37,8,151,305,524,143,76,Bing,Facebook
2023-12-04 21:52:41,13,140,309,603,127,167,Amazon,Facebook
2023-12-04 21:52:45,48,201,556,759,153,50,Youtube,Facebook
2023-12-04 21:52:49,116,274,453,672,158,61,Bing,Youtube
2023-12-04 21:52:52,215,362,524,827,147,156,Amazon,Youtube
2023-12-04 21:52:57,45,152,422,571,107,42,Youtube,Youtube
2023-12-04 21:53:01,7,141,302,530,134,94,Bing,cirtic
2023-12-04 21:53:03,5,106,217,498,101,180,Amazon,cirtic
2023-12-04 21:53:06,41,147,525,667,106,36,Youtube,cirtic
2023-12-04 21:53:10,7,135,280,500,128,92,Bing,when would there be
2023-12-04 21:53:12,5,109,217,525,104,204,Amazon,when would there be
2023-12-04 21:53:16,37,143,525,663,106,32,Youtube,when would there be
2023-12-04 21:53:20,115,239,379,614,124,111,Bing,search the map for new
2023-12-04 21:53:22,8,110,223,479,102,154,Amazon,search the map for new
2023-12-04 21:53:25,42,153,523,677,111,43,Youtube,search the map for new
2023-12-04 21:53:30,120,250,393,595,130,72,Bing,suggestions on finals
2023-12-04 21:53:32,7,109,219,481,102,160,Amazon,suggestions on finals
2023-12-04 21:53:35,41,144,510,650,103,37,Youtube,suggestions on finals
2023-12-04 21:53:40,7,144,296,515,137,82,Bing,start
2023-12-04 21:53:43,9,112,222,482,103,157,Amazon,start
2023-12-04 21:53:47,49,155,528,668,106,34,Youtube,start
2023-12-04 21:53:51,6,139,281,479,133,65,Bing,ending
2023-12-04 21:53:54,15,114,222,563,99,242,Amazon,ending
2023-12-04 21:53:59,43,161,538,683,118,27,Youtube,ending
2023-12-04 21:54:04,100,229,372,580,129,79,Bing,safety
2023-12-04 21:54:06,13,114,225,495,101,169,Amazon,safety
2023-12-04 21:54:10,64,176,441,598,112,45,Youtube,safety
2023-12-04 21:54:14,8,189,373,728,181,174,Bing,data
2023-12-04 21:54:17,368,469,582,844,101,161,Amazon,data
2023-12-04 21:54:22,165,270,671,815,105,39,Youtube,data
2023-12-04 21:54:28,6,136,283,491,130,78,Bing,DDIO
2023-12-04 21:54:30,4,104,217,479,100,162,Amazon,DDIO
2023-12-04 21:54:33,47,156,621,761,109,31,Youtube,DDIO
2023-12-04 21:54:38,7,134,279,490,127,84,Bing,MSFG
2023-12-04 21:54:40,13,112,219,471,99,153,Amazon,MSFG
2023-12-04 21:54:43,39,151,627,782,112,43,Youtube,MSFG
2023-12-04 21:54:48,123,267,425,646,144,77,Bing,HOA
2023-12-04 21:54:50,13,119,230,484,106,148,Amazon,HOA
2023-12-04 21:54:53,45,155,522,662,110,30,Youtube,HOA
2023-12-04 21:54:58,7,143,296,519,136,87,Bing,FAFR
2023-12-04 21:55:00,12,114,225,481,102,154,Amazon,FAFR
2023-12-04 21:55:03,45,153,525,660,108,27,Youtube,FAFR
2023-12-04 21:55:07,6,144,302,517,138,77,Bing,WieSOichDichEmpfangen
2023-12-04 21:55:09,7,112,223,496,105,168,Amazon,WieSOichDichEmpfangen
2023-12-04 21:55:12,44,151,541,681,107,33,Youtube,WieSOichDichEmpfangen
2023-12-04 21:55:17,97,231,388,617,134,95,Bing,sagmichbitte
2023-12-04 21:55:18,5,107,224,497,102,171,Amazon,sagmichbitte
2023-12-04 21:55:22,36,144,514,657,108,35,Youtube,sagmichbitte
2023-12-04 21:55:26,7,143,295,512,136,81,Bing,ilAuraitSuffi
2023-12-04 21:55:28,7,109,217,498,102,179,Amazon,ilAuraitSuffi
2023-12-04 21:55:32,31,139,507,652,108,37,Youtube,ilAuraitSuffi
2023-12-04 21:55:47,100,234,383,600,134,83,Bing,Carnegie Mellon University
2023-12-04 21:55:49,286,386,506,771,100,165,Amazon,Carnegie Mellon University
2023-12-04 21:55:52,50,160,537,676,110,29,Youtube,Carnegie Mellon University
2023-12-04 21:55:57,6,144,298,512,138,76,Bing,Airbnb
2023-12-04 21:56:00,7,110,217,477,103,157,Amazon,Airbnb
2023-12-04 21:56:04,48,158,429,577,110,38,Youtube,Airbnb
2023-12-04 21:56:08,112,247,400,620,135,85,Bing,Facebook
2023-12-04 21:56:11,14,117,229,671,103,339,Amazon,Facebook
2023-12-04 21:56:14,45,148,529,670,103,38,Youtube,Facebook
2023-12-04 21:56:18,7,143,308,532,136,88,Bing,Youtube
2023-12-04 21:56:21,10,109,221,472,99,152,Amazon,Youtube
2023-12-04 21:56:25,48,157,419,563,109,35,Youtube,Youtube
2023-12-04 21:56:29,7,147,305,531,140,86,Bing,cirtic
2023-12-04 21:56:31,4,104,213,468,100,155,Amazon,cirtic
2023-12-04 21:56:35,38,144,514,650,106,30,Youtube,cirtic
2023-12-04 21:56:40,8,144,309,526,136,81,Bing,when would there be
2023-12-04 21:56:41,5,102,211,473,97,165,Amazon,when would there be
2023-12-04 21:56:45,39,146,533,683,107,43,Youtube,when would there be
2023-12-04 21:56:49,7,144,301,516,137,78,Bing,search the map for new
2023-12-04 21:56:51,11,111,218,487,100,169,Amazon,search the map for new
2023-12-04 21:56:55,52,160,544,707,108,55,Youtube,search the map for new
2023-12-04 21:56:59,101,240,386,596,139,71,Bing,suggestions on finals
2023-12-04 21:57:02,7,105,215,475,98,162,Amazon,suggestions on finals
2023-12-04 21:57:05,52,162,543,695,110,42,Youtube,suggestions on finals
2023-12-04 21:57:09,6,144,306,528,138,84,Bing,start
2023-12-04 21:57:12,206,308,421,857,102,334,Amazon,start
2023-12-04 21:57:15,1701745032473,1701745032580,1701745032960,1701745033107,107,40,Youtube,start
2023-12-04 21:57:20,6,145,300,519,139,80,Bing,ending
2023-12-04 21:57:23,5,105,213,471,100,158,Amazon,ending
2023-12-04 21:57:26,52,159,531,674,107,36,Youtube,ending
2023-12-04 21:57:31,115,251,406,622,136,80,Bing,safety
2023-12-04 21:57:33,5,112,222,533,107,204,Amazon,safety
2023-12-04 21:57:39,51,160,560,702,109,33,Youtube,safety
2023-12-04 21:57:43,7,144,302,519,137,80,Bing,data
2023-12-04 21:57:46,4,104,213,655,100,342,Amazon,data
2023-12-04 21:57:49,53,162,427,592,109,56,Youtube,data
2023-12-04 21:57:54,7,146,309,524,139,76,Bing,DDIO
2023-12-04 21:57:56,5,110,221,679,105,353,Amazon,DDIO
2023-12-04 21:58:00,40,149,580,724,109,35,Youtube,DDIO
2023-12-04 21:58:05,7,145,294,512,138,80,Bing,MSFG
2023-12-04 21:58:07,11,114,227,487,103,157,Amazon,MSFG
2023-12-04 21:58:11,46,151,524,669,105,40,Youtube,MSFG
2023-12-04 21:58:16,7,142,298,517,135,84,Bing,HOA
2023-12-04 21:58:18,7,107,223,474,100,151,Amazon,HOA
2023-12-04 21:58:21,45,159,550,689,114,25,Youtube,HOA
2023-12-04 21:58:25,97,231,383,597,134,80,Bing,FAFR
2023-12-04 21:58:27,5,106,227,487,101,159,Amazon,FAFR
2023-12-04 21:58:31,46,157,535,689,111,43,Youtube,FAFR
2023-12-04 21:58:35,7,146,301,516,139,76,Bing,WieSOichDichEmpfangen
2023-12-04 21:58:37,8,107,215,475,99,161,Amazon,WieSOichDichEmpfangen
2023-12-04 21:58:40,37,149,518,669,112,39,Youtube,WieSOichDichEmpfangen
2023-12-04 21:58:44,6,143,294,509,137,78,Bing,sagmichbitte
2023-12-04 21:58:46,8,110,224,476,102,150,Amazon,sagmichbitte
2023-12-04 21:58:49,39,145,526,662,106,30,Youtube,sagmichbitte
2023-12-04 21:58:53,121,261,412,629,140,77,Bing,ilAuraitSuffi
2023-12-04 21:58:55,7,106,214,480,99,167,Amazon,ilAuraitSuffi
2023-12-04 21:58:59,34,140,521,871,106,244,Youtube,ilAuraitSuffi
