dateTime,connectStart,secureConnectionStart,requestStart,responseStart,networkTime,serverTime,service site,searching string
2023-12-04 14:46:50,89,174,416,644,85,143,Bing,Carnegie Mellon University
2023-12-04 14:46:53,124,209,301,528,85,142,Amazon,Carnegie Mellon University
2023-12-04 14:46:57,146,240,574,756,94,88,Youtube,Carnegie Mellon University
2023-12-04 14:47:03,8,97,198,642,89,355,Bing,Airbnb
2023-12-04 14:47:05,7,92,188,413,85,140,Amazon,Airbnb
2023-12-04 14:47:09,54,151,594,757,97,66,Youtube,Airbnb
2023-12-04 14:47:15,7,94,200,440,87,153,Bing,Facebook
2023-12-04 14:47:17,92,173,267,487,81,139,Amazon,Facebook
2023-12-04 14:47:21,59,152,580,735,93,62,Youtube,Facebook
2023-12-04 14:47:26,90,181,341,509,91,77,Bing,Youtube
2023-12-04 14:47:29,11,110,212,439,99,128,Amazon,Youtube
2023-12-04 14:47:33,65,162,942,1129,97,90,Youtube,Youtube
2023-12-04 14:47:39,9,92,194,368,83,91,Bing,cirtic
2023-12-04 14:47:41,8,93,191,414,85,138,Amazon,cirtic
2023-12-04 14:47:45,56,154,584,734,98,52,Youtube,cirtic
2023-12-04 14:47:50,9,100,208,384,91,85,Bing,when would there be
2023-12-04 14:47:52,13,102,199,412,89,124,Amazon,when would there be
2023-12-04 14:47:56,66,167,601,788,101,86,Youtube,when would there be
2023-12-04 14:48:02,7,91,195,429,84,150,Bing,search the map for new
2023-12-04 14:48:04,17,105,213,469,88,168,Amazon,search the map for new
2023-12-04 14:48:08,44,138,578,723,94,51,Youtube,search the map for new
2023-12-04 14:48:13,7,89,199,366,82,85,Bing,suggestions on finals
2023-12-04 14:48:17,14,98,196,429,84,149,Amazon,suggestions on finals
2023-12-04 14:48:21,51,146,567,721,95,59,Youtube,suggestions on finals
2023-12-04 14:48:26,94,179,285,507,85,137,Bing,start
2023-12-04 14:48:29,18,103,195,423,85,143,Amazon,start
2023-12-04 14:48:33,59,156,592,753,97,64,Youtube,start
2023-12-04 14:48:38,9,96,199,389,87,103,Bing,ending
2023-12-04 14:48:40,5,88,184,412,83,145,Amazon,ending
2023-12-04 14:48:44,70,168,637,791,98,56,Youtube,ending
2023-12-04 14:48:49,10,94,208,418,84,126,Bing,safety
2023-12-04 14:48:52,6,88,180,394,82,132,Amazon,safety
2023-12-04 14:48:56,49,151,598,757,102,57,Youtube,safety
2023-12-04 14:49:01,8,90,193,441,82,166,Bing,data
2023-12-04 14:49:04,7,91,186,416,84,146,Amazon,data
2023-12-04 14:49:15,15,105,220,387,90,77,Bing,DDIO
2023-12-04 14:49:17,15,99,197,434,84,153,Amazon,DDIO
2023-12-04 14:49:21,61,155,618,767,94,55,Youtube,DDIO
2023-12-04 14:49:26,6,92,191,344,86,67,Bing,MSFG
2023-12-04 14:49:27,17,100,204,429,83,142,Amazon,MSFG
2023-12-04 14:49:31,52,157,590,748,105,53,Youtube,MSFG
2023-12-04 14:49:36,10,94,197,348,84,67,Bing,HOA
2023-12-04 14:49:38,116,200,294,523,84,145,Amazon,HOA
2023-12-04 14:49:46,56,154,597,755,98,60,Youtube,HOA
2023-12-04 14:49:51,9,98,234,495,89,172,Bing,FAFR
2023-12-04 14:49:53,5,90,189,406,85,132,Amazon,FAFR
2023-12-04 14:49:58,52,155,608,775,103,64,Youtube,FAFR
2023-12-04 14:50:03,7,91,440,613,84,89,Bing,WieSOichDichEmpfangen
2023-12-04 14:50:06,6,149,242,512,143,127,Amazon,WieSOichDichEmpfangen
2023-12-04 14:50:13,61,159,999,1451,98,354,Youtube,WieSOichDichEmpfangen
2023-12-04 14:50:18,8,374,478,1007,366,163,Bing,sagmichbitte
2023-12-04 14:50:21,6,92,191,493,86,216,Amazon,sagmichbitte
2023-12-04 14:50:26,50,184,614,754,134,6,Youtube,sagmichbitte
2023-12-04 14:50:31,9,91,194,383,82,107,Bing,ilAuraitSuffi
2023-12-04 14:50:35,6,93,196,431,87,148,Amazon,ilAuraitSuffi
2023-12-04 14:50:55,7,94,191,363,87,85,Bing,Carnegie Mellon University
2023-12-04 14:50:57,93,177,270,497,84,143,Amazon,Carnegie Mellon University
2023-12-04 14:51:02,48,142,577,734,94,63,Youtube,Carnegie Mellon University
2023-12-04 14:51:08,7,92,368,782,85,329,Bing,Airbnb
2023-12-04 14:51:12,5,92,188,508,87,233,Amazon,Airbnb
2023-12-04 14:51:24,242,329,445,615,87,83,Bing,Facebook
2023-12-04 14:51:26,10,103,202,428,93,133,Amazon,Facebook
2023-12-04 14:51:30,51,143,600,752,92,60,Youtube,Facebook
2023-12-04 14:51:36,16,111,226,377,95,56,Bing,Youtube
2023-12-04 14:51:38,4,89,186,417,85,146,Amazon,Youtube
2023-12-04 14:51:43,55,154,646,792,99,47,Youtube,Youtube
2023-12-04 14:51:48,90,174,277,462,84,101,Bing,cirtic
2023-12-04 14:51:50,9,102,194,424,93,137,Amazon,cirtic
2023-12-04 14:51:55,58,152,591,748,94,63,Youtube,cirtic
2023-12-04 14:52:00,18,120,248,483,102,133,Bing,when would there be
2023-12-04 14:52:03,9,99,202,438,90,146,Amazon,when would there be
2023-12-04 14:52:07,50,141,578,726,91,57,Youtube,when would there be
2023-12-04 14:52:13,12,110,220,377,98,59,Bing,search the map for new
2023-12-04 14:52:15,6,91,182,418,85,151,Amazon,search the map for new
2023-12-04 14:52:19,65,159,592,752,94,66,Youtube,search the map for new
2023-12-04 14:52:24,11,95,198,364,84,82,Bing,suggestions on finals
2023-12-04 14:52:26,7,95,197,428,88,143,Amazon,suggestions on finals
2023-12-04 14:52:32,52,146,631,819,94,94,Youtube,suggestions on finals
2023-12-04 14:52:37,10,93,201,353,83,69,Bing,start
2023-12-04 14:52:39,11,93,186,411,82,143,Amazon,start
2023-12-04 14:52:44,50,145,576,732,95,61,Youtube,start
2023-12-04 14:52:49,10,94,201,378,84,93,Bing,ending
2023-12-04 14:52:51,7,90,192,413,83,138,Amazon,ending
2023-12-04 14:52:54,55,152,590,750,97,63,Youtube,ending
2023-12-04 14:53:00,7,89,189,437,82,166,Bing,safety
2023-12-04 14:53:02,4,88,179,415,84,152,Amazon,safety
2023-12-04 14:53:07,65,161,641,831,96,94,Youtube,safety
2023-12-04 14:53:13,97,179,276,508,82,150,Bing,data
2023-12-04 14:53:16,6,92,187,416,86,143,Amazon,data
2023-12-04 14:53:20,82,179,667,825,97,61,Youtube,data
2023-12-04 14:53:26,8,91,192,351,83,76,Bing,DDIO
2023-12-04 14:53:28,127,212,313,586,85,188,Amazon,DDIO
2023-12-04 14:53:32,49,144,568,736,95,73,Youtube,DDIO
2023-12-04 14:53:41,6,260,355,784,254,175,Amazon,MSFG
2023-12-04 14:53:49,52,52,1515,1832,0,317,Youtube,MSFG
2023-12-04 14:53:54,90,173,277,447,83,87,Bing,HOA
2023-12-04 14:53:56,8,91,189,404,83,132,Amazon,HOA
2023-12-04 14:53:59,45,139,575,739,94,70,Youtube,HOA
2023-12-04 14:54:05,8,92,192,490,84,214,Bing,FAFR
2023-12-04 14:54:07,5,88,180,398,83,135,Amazon,FAFR
2023-12-04 14:54:11,54,149,610,770,95,65,Youtube,FAFR
2023-12-04 14:54:18,124,473,575,929,349,5,Bing,WieSOichDichEmpfangen
2023-12-04 14:54:22,7,96,358,607,89,160,Amazon,WieSOichDichEmpfangen
2023-12-04 14:54:33,9,94,196,491,85,210,Bing,sagmichbitte
2023-12-04 14:54:35,4,91,184,402,87,131,Amazon,sagmichbitte
2023-12-04 14:54:40,44,139,577,728,95,56,Youtube,sagmichbitte
2023-12-04 14:54:48,10,94,197,447,84,166,Bing,ilAuraitSuffi
2023-12-04 14:54:50,5,90,187,406,85,134,Amazon,ilAuraitSuffi
2023-12-04 14:54:54,70,181,616,764,111,37,Youtube,ilAuraitSuffi
2023-12-04 14:55:09,88,175,271,429,87,71,Bing,Carnegie Mellon University
2023-12-04 14:55:12,5,88,178,409,83,148,Amazon,Carnegie Mellon University
2023-12-04 14:55:16,52,146,481,638,94,63,Youtube,Carnegie Mellon University
2023-12-04 14:55:21,11,95,201,365,84,80,Bing,Airbnb
2023-12-04 14:55:24,7,95,188,413,88,137,Amazon,Airbnb
2023-12-04 14:55:28,69,165,494,686,96,96,Youtube,Airbnb
2023-12-04 14:55:37,8,315,460,775,307,8,Amazon,Facebook
2023-12-04 14:55:41,45,139,564,746,94,88,Youtube,Facebook
2023-12-04 14:55:46,129,219,335,489,90,64,Bing,Youtube
2023-12-04 14:55:49,7,90,192,417,83,142,Amazon,Youtube
2023-12-04 14:55:54,54,150,627,775,96,52,Youtube,Youtube
2023-12-04 14:56:02,13,110,213,472,97,162,Bing,cirtic
2023-12-04 14:56:04,7,92,184,417,85,148,Amazon,cirtic
2023-12-04 14:56:08,54,146,600,747,92,55,Youtube,cirtic
2023-12-04 14:56:14,12,95,193,382,83,106,Bing,when would there be
2023-12-04 14:56:16,5,88,182,415,83,150,Amazon,when would there be
2023-12-04 14:56:20,63,164,600,748,101,47,Youtube,when would there be
2023-12-04 14:56:26,8,90,189,349,82,78,Bing,search the map for new
2023-12-04 14:56:28,11,95,189,428,84,155,Amazon,search the map for new
2023-12-04 14:56:33,55,149,620,772,94,58,Youtube,search the map for new
2023-12-04 14:56:39,12,97,202,439,85,152,Bing,suggestions on finals
2023-12-04 14:56:41,6,91,188,406,85,133,Amazon,suggestions on finals
2023-12-04 14:56:45,54,152,586,775,98,91,Youtube,suggestions on finals
2023-12-04 14:56:51,90,175,274,565,85,206,Bing,start
2023-12-04 14:56:54,8,92,186,408,84,138,Amazon,start
2023-12-04 14:56:58,63,165,620,812,102,90,Youtube,start
2023-12-04 14:57:03,11,96,202,367,85,80,Bing,ending
2023-12-04 14:57:05,8,88,181,397,80,136,Amazon,ending
2023-12-04 14:57:10,50,145,571,727,95,61,Youtube,ending
2023-12-04 14:57:16,11,95,194,370,84,92,Bing,safety
2023-12-04 14:57:19,6,95,197,434,89,148,Amazon,safety
2023-12-04 14:57:24,210,306,843,1001,96,62,Youtube,safety
2023-12-04 14:57:29,10,97,201,356,87,68,Bing,data
2023-12-04 14:57:32,6,93,184,407,87,136,Amazon,data
2023-12-04 14:57:37,56,152,626,786,96,64,Youtube,data
2023-12-04 14:57:42,11,94,220,630,83,327,Bing,DDIO
2023-12-04 14:57:44,6,89,183,402,83,136,Amazon,DDIO
2023-12-04 14:57:48,49,143,603,795,94,98,Youtube,DDIO
2023-12-04 14:57:53,11,115,245,412,104,63,Bing,MSFG
2023-12-04 14:57:55,5,89,183,399,84,132,Amazon,MSFG
2023-12-04 14:58:00,57,150,653,811,93,65,Youtube,MSFG
2023-12-04 14:58:06,19,111,212,392,92,88,Bing,HOA
2023-12-04 14:58:08,5,87,183,409,82,144,Amazon,HOA
2023-12-04 14:58:12,47,139,597,751,92,62,Youtube,HOA
2023-12-04 14:58:18,7,89,195,394,82,117,Bing,FAFR
2023-12-04 14:58:20,5,91,190,427,86,151,Amazon,FAFR
2023-12-04 14:58:24,57,149,575,725,92,58,Youtube,FAFR
2023-12-04 14:58:29,10,96,193,422,86,143,Bing,WieSOichDichEmpfangen
2023-12-04 14:58:31,8,92,188,404,84,132,Amazon,WieSOichDichEmpfangen
2023-12-04 14:58:34,56,181,610,805,125,70,Youtube,WieSOichDichEmpfangen
2023-12-04 14:58:40,88,174,272,470,86,112,Bing,sagmichbitte
2023-12-04 14:58:41,4,88,180,394,84,130,Amazon,sagmichbitte
2023-12-04 14:58:44,64,159,661,809,95,53,Youtube,sagmichbitte
2023-12-04 14:58:50,8,93,193,402,85,124,Bing,ilAuraitSuffi
2023-12-04 14:58:52,7,91,188,406,84,134,Amazon,ilAuraitSuffi
2023-12-04 14:58:56,49,148,607,759,99,53,Youtube,ilAuraitSuffi
dateTime,connectStart,secureConnectionStart,requestStart,responseStart,networkTime,serverTime,service site,searching string
2023-12-04 14:46:56,9,93,201,490,84,205,Bing,Carnegie Mellon University
2023-12-04 14:46:59,8,92,186,428,84,158,Amazon,Carnegie Mellon University
2023-12-04 14:47:03,55,148,594,748,93,61,Youtube,Carnegie Mellon University
2023-12-04 14:47:09,9,91,191,448,82,175,Bing,Airbnb
2023-12-04 14:47:11,12,94,188,410,82,140,Amazon,Airbnb
2023-12-04 14:47:15,49,144,575,721,95,51,Youtube,Airbnb
2023-12-04 14:47:20,6,89,200,380,83,97,Bing,Facebook
2023-12-04 14:47:23,7,126,217,439,119,103,Amazon,Facebook
2023-12-04 14:47:27,64,158,580,730,94,56,Youtube,Facebook
2023-12-04 14:47:33,7,91,200,385,84,101,Bing,Youtube
2023-12-04 14:47:35,9,100,201,436,91,144,Amazon,Youtube
2023-12-04 14:47:40,60,151,479,647,91,77,Youtube,Youtube
2023-12-04 14:47:45,90,184,295,457,94,68,Bing,cirtic
2023-12-04 14:47:47,10,92,186,420,82,152,Amazon,cirtic
2023-12-04 14:47:51,59,152,579,724,93,52,Youtube,cirtic
2023-12-04 14:47:57,15,118,225,380,103,52,Bing,when would there be
2023-12-04 14:47:59,5,89,184,408,84,140,Amazon,when would there be
2023-12-04 14:48:04,50,145,576,730,95,59,Youtube,when would there be
2023-12-04 14:48:09,95,180,290,494,85,119,Bing,search the map for new
2023-12-04 14:48:12,6,91,181,404,85,138,Amazon,search the map for new
2023-12-04 14:48:17,56,152,581,737,96,60,Youtube,search the map for new
2023-12-04 14:48:22,20,134,241,433,114,78,Bing,suggestions on finals
2023-12-04 14:48:24,5,91,182,398,86,130,Amazon,suggestions on finals
2023-12-04 14:48:28,53,142,566,739,89,84,Youtube,suggestions on finals
2023-12-04 14:48:34,11,95,202,400,84,114,Bing,start
2023-12-04 14:48:37,97,181,272,505,84,149,Amazon,start
2023-12-04 14:48:41,150,244,707,870,94,69,Youtube,start
2023-12-04 14:48:46,89,172,267,594,83,244,Bing,ending
2023-12-04 14:48:48,9,94,226,461,85,150,Amazon,ending
2023-12-04 14:48:53,51,146,570,725,95,60,Youtube,ending
2023-12-04 14:48:58,9,91,190,409,82,137,Bing,safety
2023-12-04 14:49:02,13,96,190,414,83,141,Amazon,safety
2023-12-04 14:49:06,90,187,556,929,97,276,Youtube,safety
2023-12-04 14:49:11,10,93,202,448,83,163,Bing,data
2023-12-04 14:49:14,5,90,184,398,85,129,Amazon,data
2023-12-04 14:49:19,59,152,598,751,93,60,Youtube,data
2023-12-04 14:49:25,93,178,276,670,85,309,Bing,DDIO
2023-12-04 14:49:27,5,88,183,395,83,129,Amazon,DDIO
2023-12-04 14:49:30,52,152,603,751,100,48,Youtube,DDIO
2023-12-04 14:49:36,9,124,262,428,115,51,Bing,MSFG
2023-12-04 14:49:38,5,88,178,400,83,139,Amazon,MSFG
2023-12-04 14:49:46,50,143,598,747,93,56,Youtube,MSFG
2023-12-04 14:49:51,11,101,204,367,90,73,Bing,HOA
2023-12-04 14:49:53,6,98,193,420,92,135,Amazon,HOA
2023-12-04 14:49:57,46,168,611,775,122,42,Youtube,HOA
2023-12-04 14:50:03,6,116,231,550,110,209,Bing,FAFR
2023-12-04 14:50:06,6,92,192,500,86,222,Amazon,FAFR
2023-12-04 14:50:19,7,297,397,781,290,94,Bing,WieSOichDichEmpfangen
2023-12-04 14:50:21,15,319,439,749,304,6,Amazon,WieSOichDichEmpfangen
2023-12-04 14:50:25,42,138,583,748,96,69,Youtube,WieSOichDichEmpfangen
2023-12-04 14:50:30,110,191,293,548,81,174,Bing,sagmichbitte
2023-12-04 14:50:32,5,92,191,403,87,125,Amazon,sagmichbitte
2023-12-04 14:50:37,47,142,650,1405,95,660,Youtube,sagmichbitte
2023-12-04 14:50:43,4,88,189,389,84,116,Bing,ilAuraitSuffi
2023-12-04 14:50:45,4,93,188,402,89,125,Amazon,ilAuraitSuffi
2023-12-04 14:50:49,49,149,584,748,100,64,Youtube,ilAuraitSuffi
2023-12-04 14:51:05,9,92,189,556,83,284,Bing,Carnegie Mellon University
2023-12-04 14:51:08,6,89,184,405,83,138,Amazon,Carnegie Mellon University
2023-12-04 14:51:20,7,93,227,602,86,289,Bing,Airbnb
2023-12-04 14:51:24,5,87,178,510,82,250,Amazon,Airbnb
2023-12-04 14:51:28,56,151,495,708,95,118,Youtube,Airbnb
2023-12-04 14:51:33,7,95,198,347,88,61,Bing,Facebook
2023-12-04 14:51:35,5,88,182,405,83,140,Amazon,Facebook
2023-12-04 14:51:40,63,156,673,886,93,120,Youtube,Facebook
2023-12-04 14:51:45,8,95,196,587,87,304,Bing,Youtube
2023-12-04 14:51:49,10,93,192,417,83,142,Amazon,Youtube
2023-12-04 14:51:54,91,215,554,738,124,60,Youtube,Youtube
2023-12-04 14:51:59,15,108,214,384,93,77,Bing,cirtic
2023-12-04 14:52:01,7,87,181,401,80,140,Amazon,cirtic
2023-12-04 14:52:06,69,167,659,810,98,53,Youtube,cirtic
2023-12-04 14:52:11,9,91,194,573,82,297,Bing,when would there be
2023-12-04 14:52:13,93,174,272,490,81,137,Amazon,when would there be
2023-12-04 14:52:17,60,191,627,779,131,21,Youtube,when would there be
2023-12-04 14:52:23,9,91,195,405,82,128,Bing,search the map for new
2023-12-04 14:52:25,16,99,197,433,83,153,Amazon,search the map for new
2023-12-04 14:52:31,49,152,670,861,103,88,Youtube,search the map for new
2023-12-04 14:52:36,93,177,322,499,84,93,Bing,suggestions on finals
2023-12-04 14:52:39,6,94,189,409,88,132,Amazon,suggestions on finals
2023-12-04 14:52:44,69,160,594,756,91,71,Youtube,suggestions on finals
2023-12-04 14:52:50,9,98,232,971,89,650,Bing,start
2023-12-04 14:52:52,20,105,196,420,85,139,Amazon,start
2023-12-04 14:52:56,55,149,612,767,94,61,Youtube,start
2023-12-04 14:53:02,11,97,212,384,86,86,Bing,ending
2023-12-04 14:53:04,11,118,210,453,107,136,Amazon,ending
2023-12-04 14:53:09,61,257,806,1016,196,14,Youtube,ending
2023-12-04 14:53:15,10,100,211,391,90,90,Bing,safety
2023-12-04 14:53:17,10,120,222,457,110,125,Amazon,safety
2023-12-04 14:53:22,65,164,631,821,99,91,Youtube,safety
2023-12-04 14:53:27,11,95,225,415,84,106,Bing,data
2023-12-04 14:53:30,6,105,207,439,99,133,Amazon,data
2023-12-04 14:53:34,52,144,574,761,92,95,Youtube,data
2023-12-04 14:53:40,6,308,416,834,302,116,Bing,DDIO
2023-12-04 14:53:45,5,100,195,419,95,129,Amazon,DDIO
2023-12-04 14:53:56,8,97,209,389,89,91,Bing,MSFG
2023-12-04 14:53:58,6,89,181,410,83,146,Amazon,MSFG
2023-12-04 14:54:02,140,233,676,825,93,56,Youtube,MSFG
2023-12-04 14:54:07,10,97,236,419,87,96,Bing,HOA
2023-12-04 14:54:10,20,104,201,424,84,139,Amazon,HOA
2023-12-04 14:54:14,62,155,644,795,93,58,Youtube,HOA
2023-12-04 14:54:20,11,95,195,466,84,187,Bing,FAFR
2023-12-04 14:54:23,5,94,195,509,89,225,Amazon,FAFR
2023-12-04 14:54:27,56,152,617,781,96,68,Youtube,FAFR
2023-12-04 14:54:32,6,89,195,398,83,120,Bing,WieSOichDichEmpfangen
2023-12-04 14:54:34,105,188,279,511,83,149,Amazon,WieSOichDichEmpfangen
2023-12-04 14:54:38,62,158,589,781,96,96,Youtube,WieSOichDichEmpfangen
2023-12-04 14:54:43,8,93,198,377,85,94,Bing,sagmichbitte
2023-12-04 14:54:45,91,175,268,484,84,132,Amazon,sagmichbitte
2023-12-04 14:54:49,49,143,599,750,94,57,Youtube,sagmichbitte
2023-12-04 14:54:54,13,103,210,369,90,69,Bing,ilAuraitSuffi
2023-12-04 14:54:56,6,92,184,403,86,133,Amazon,ilAuraitSuffi
2023-12-04 14:55:00,34,127,555,709,93,61,Youtube,ilAuraitSuffi
2023-12-04 14:55:16,10,92,196,378,82,100,Bing,Carnegie Mellon University
2023-12-04 14:55:19,6,89,183,411,83,145,Amazon,Carnegie Mellon University
2023-12-04 14:55:23,56,148,598,759,92,69,Youtube,Carnegie Mellon University
2023-12-04 14:55:28,9,98,210,462,89,163,Bing,Airbnb
2023-12-04 14:55:30,7,93,185,403,86,132,Amazon,Airbnb
2023-12-04 14:55:35,43,136,583,742,93,66,Youtube,Airbnb
2023-12-04 14:55:40,9,90,190,391,81,120,Bing,Facebook
2023-12-04 14:55:42,177,260,352,574,83,139,Amazon,Facebook
2023-12-04 14:55:47,44,138,565,717,94,58,Youtube,Facebook
2023-12-04 14:55:53,18,103,216,514,85,213,Bing,Youtube
2023-12-04 14:55:55,10,97,194,415,87,134,Amazon,Youtube
2023-12-04 14:56:00,72,169,646,832,97,89,Youtube,Youtube
2023-12-04 14:56:06,8,90,193,354,82,79,Bing,cirtic
2023-12-04 14:56:08,7,91,184,537,84,269,Amazon,cirtic
2023-12-04 14:56:12,75,175,614,760,100,46,Youtube,cirtic
2023-12-04 14:56:17,12,102,212,395,90,93,Bing,when would there be
2023-12-04 14:56:19,8,91,185,397,83,129,Amazon,when would there be
2023-12-04 14:56:23,68,165,636,830,97,97,Youtube,when would there be
2023-12-04 14:56:29,18,110,219,405,92,94,Bing,search the map for new
2023-12-04 14:56:31,9,93,188,407,84,135,Amazon,search the map for new
2023-12-04 14:56:35,61,152,629,809,91,89,Youtube,search the map for new
2023-12-04 14:56:41,8,90,196,366,82,88,Bing,suggestions on finals
2023-12-04 14:56:44,9,93,187,407,84,136,Amazon,suggestions on finals
2023-12-04 14:56:48,51,149,589,782,98,95,Youtube,suggestions on finals
2023-12-04 14:56:53,8,95,208,528,87,233,Bing,start
2023-12-04 14:56:56,11,98,192,417,87,138,Amazon,start
2023-12-04 14:57:00,51,144,579,767,93,95,Youtube,start
2023-12-04 14:57:06,95,181,304,529,86,139,Bing,ending
2023-12-04 14:57:08,5,93,188,424,88,148,Amazon,ending
2023-12-04 14:57:12,50,143,574,730,93,63,Youtube,ending
2023-12-04 14:57:17,11,95,202,378,84,92,Bing,safety
2023-12-04 14:57:20,5,94,188,425,89,148,Amazon,safety
2023-12-04 14:57:24,58,155,598,747,97,52,Youtube,safety
2023-12-04 14:57:30,9,93,207,363,84,72,Bing,data
2023-12-04 14:57:32,9,92,184,398,83,131,Amazon,data
2023-12-04 14:57:37,79,185,656,815,106,53,Youtube,data
2023-12-04 14:57:42,10,102,211,388,92,85,Bing,DDIO
2023-12-04 14:57:44,5,88,181,402,83,138,Amazon,DDIO
2023-12-04 14:57:49,46,143,614,776,97,65,Youtube,DDIO
2023-12-04 14:57:53,16,107,238,431,91,102,Bing,MSFG
2023-12-04 14:57:56,8,91,181,413,83,149,Amazon,MSFG
2023-12-04 14:57:59,72,170,652,823,98,73,Youtube,MSFG
2023-12-04 14:58:05,8,96,209,397,88,100,Bing,HOA
2023-12-04 14:58:07,97,181,277,505,84,144,Amazon,HOA
2023-12-04 14:58:11,61,156,586,735,95,54,Youtube,HOA
2023-12-04 14:58:17,87,172,278,1042,85,679,Bing,FAFR
2023-12-04 14:58:19,5,89,186,415,84,145,Amazon,FAFR
2023-12-04 14:58:24,52,147,572,726,95,59,Youtube,FAFR
2023-12-04 14:58:29,10,96,198,397,86,113,Bing,WieSOichDichEmpfangen
2023-12-04 14:58:31,89,174,274,506,85,147,Amazon,WieSOichDichEmpfangen
2023-12-04 14:58:35,65,160,598,751,95,58,Youtube,WieSOichDichEmpfangen
2023-12-04 14:58:40,9,92,203,399,83,113,Bing,sagmichbitte
2023-12-04 14:58:42,8,92,187,404,84,133,Amazon,sagmichbitte
2023-12-04 14:58:45,46,139,598,762,93,71,Youtube,sagmichbitte
2023-12-04 14:58:50,10,93,195,379,83,101,Bing,ilAuraitSuffi
2023-12-04 14:58:52,7,90,184,407,83,140,Amazon,ilAuraitSuffi
2023-12-04 14:58:56,36,130,558,708,94,56,Youtube,ilAuraitSuffi
