dateTime,connectStart,secureConnectionStart,requestStart,responseStart,networkTime,serverTime,service site,searching string
2023-12-04 14:21:59,80,118,173,411,38,200,Bing,Carnegie Mellon University
2023-12-04 14:22:01,40,99,169,344,59,116,Amazon,Carnegie Mellon University
2023-12-04 14:22:04,80,148,405,512,68,39,Youtube,Carnegie Mellon University
2023-12-04 14:22:09,29,70,127,616,41,448,Bing,Airbnb
2023-12-04 14:22:12,8,78,156,345,70,119,Amazon,Airbnb
2023-12-04 14:22:15,77,145,367,467,68,32,Youtube,Airbnb
2023-12-04 14:22:20,11,71,133,256,60,63,Bing,Facebook
2023-12-04 14:22:22,6,66,136,304,60,108,Amazon,Facebook
2023-12-04 14:22:25,53,125,339,436,72,25,Youtube,Facebook
2023-12-04 14:22:29,12,58,146,265,46,73,Bing,Youtube
2023-12-04 14:22:31,6,76,150,313,70,93,Amazon,Youtube
2023-12-04 14:22:34,70,144,545,667,74,48,Youtube,Youtube
2023-12-04 14:22:38,9,48,109,213,39,65,Bing,cirtic
2023-12-04 14:22:40,5,68,145,335,63,127,Amazon,cirtic
2023-12-04 14:22:43,71,145,407,538,74,57,Youtube,cirtic
2023-12-04 14:22:48,9,50,111,302,41,150,Bing,when would there be
2023-12-04 14:22:50,5,65,144,323,60,119,Amazon,when would there be
2023-12-04 14:22:52,48,127,441,525,79,5,Youtube,when would there be
2023-12-04 14:22:58,8,49,116,233,41,76,Bing,search the map for new
2023-12-04 14:23:00,9,68,137,306,59,110,Amazon,search the map for new
2023-12-04 14:23:02,56,129,351,444,73,20,Youtube,search the map for new
2023-12-04 14:23:07,8,51,111,244,43,90,Bing,suggestions on finals
2023-12-04 14:23:09,7,65,137,292,58,97,Amazon,suggestions on finals
2023-12-04 14:23:12,58,131,349,458,73,36,Youtube,suggestions on finals
2023-12-04 14:23:17,60,105,169,449,45,235,Bing,start
2023-12-04 14:23:19,13,85,163,317,72,82,Amazon,start
2023-12-04 14:23:22,58,128,340,428,70,18,Youtube,start
2023-12-04 14:23:27,9,52,125,233,43,65,Bing,ending
2023-12-04 14:23:29,6,114,190,342,108,44,Amazon,ending
2023-12-04 14:23:32,82,154,391,501,72,38,Youtube,ending
2023-12-04 14:23:37,43,82,141,263,39,83,Bing,safety
2023-12-04 14:23:40,5,63,130,288,58,100,Amazon,safety
2023-12-04 14:23:45,126,197,442,545,71,32,Youtube,safety
2023-12-04 14:23:50,8,58,125,245,50,70,Bing,data
2023-12-04 14:23:53,13,83,159,322,70,93,Amazon,data
2023-12-04 14:23:55,74,142,369,458,68,21,Youtube,data
2023-12-04 14:24:00,9,66,134,245,57,54,Bing,DDIO
2023-12-04 14:24:01,5,67,135,303,62,106,Amazon,DDIO
2023-12-04 14:24:06,51,121,358,460,70,32,Youtube,DDIO
2023-12-04 14:24:11,113,204,278,418,91,49,Bing,MSFG
2023-12-04 14:24:12,8,73,144,312,65,103,Amazon,MSFG
2023-12-04 14:24:16,52,120,329,412,68,15,Youtube,MSFG
2023-12-04 14:24:21,9,54,118,255,45,92,Bing,HOA
2023-12-04 14:24:22,8,69,148,335,61,126,Amazon,HOA
2023-12-04 14:24:32,13,141,217,526,128,181,Bing,FAFR
2023-12-04 14:24:34,6,66,138,296,60,98,Amazon,FAFR
2023-12-04 14:24:37,101,175,422,514,74,18,Youtube,FAFR
2023-12-04 14:24:42,10,53,131,258,43,84,Bing,WieSOichDichEmpfangen
2023-12-04 14:24:44,7,74,149,306,67,90,Amazon,WieSOichDichEmpfangen
2023-12-04 14:24:47,54,125,342,435,71,22,Youtube,WieSOichDichEmpfangen
2023-12-04 14:24:52,10,66,139,346,56,151,Bing,sagmichbitte
2023-12-04 14:24:53,5,63,137,305,58,110,Amazon,sagmichbitte
2023-12-04 14:24:57,64,132,336,432,68,28,Youtube,sagmichbitte
2023-12-04 14:25:02,13,83,163,369,70,136,Bing,ilAuraitSuffi
2023-12-04 14:25:03,7,67,137,307,60,110,Amazon,ilAuraitSuffi
2023-12-04 14:25:07,66,135,360,456,69,27,Youtube,ilAuraitSuffi
2023-12-04 14:25:21,7,48,102,207,41,64,Bing,Carnegie Mellon University
2023-12-04 14:25:23,5,63,131,299,58,110,Amazon,Carnegie Mellon University
2023-12-04 14:25:27,62,124,312,402,62,28,Youtube,Carnegie Mellon University
2023-12-04 14:25:38,59,131,419,524,72,33,Youtube,Airbnb
2023-12-04 14:25:43,8,53,108,244,45,91,Bing,Facebook
2023-12-04 14:25:45,9,71,139,329,62,128,Amazon,Facebook
2023-12-04 14:25:49,54,126,426,529,72,31,Youtube,Facebook
2023-12-04 14:25:54,7,71,159,315,64,92,Bing,Youtube
2023-12-04 14:25:56,11,84,161,331,73,97,Amazon,Youtube
2023-12-04 14:25:58,70,120,324,540,50,166,Youtube,Youtube
2023-12-04 14:26:02,13,70,144,312,57,111,Bing,cirtic
2023-12-04 14:26:04,9,74,145,324,65,114,Amazon,cirtic
2023-12-04 14:26:07,56,112,337,426,56,33,Youtube,cirtic
2023-12-04 14:26:12,11,69,143,259,58,58,Bing,when would there be
2023-12-04 14:26:14,11,70,139,297,59,99,Amazon,when would there be
2023-12-04 14:26:18,55,124,348,445,69,28,Youtube,when would there be
2023-12-04 14:26:24,13,55,179,323,42,102,Bing,search the map for new
2023-12-04 14:26:26,11,70,142,302,59,101,Amazon,search the map for new
2023-12-04 14:26:29,83,143,386,525,60,79,Youtube,search the map for new
2023-12-04 14:26:35,11,71,140,363,60,163,Bing,suggestions on finals
2023-12-04 14:26:37,7,65,140,299,58,101,Amazon,suggestions on finals
2023-12-04 14:26:40,51,121,309,412,70,33,Youtube,suggestions on finals
2023-12-04 14:26:45,9,52,115,237,43,79,Bing,start
2023-12-04 14:26:47,8,75,152,339,67,120,Amazon,start
2023-12-04 14:26:50,95,159,374,465,64,27,Youtube,start
2023-12-04 14:26:55,9,64,136,260,55,69,Bing,ending
2023-12-04 14:26:57,8,71,141,309,63,105,Amazon,ending
2023-12-04 14:26:59,51,107,289,385,56,40,Youtube,ending
2023-12-04 14:27:04,12,56,118,221,44,59,Bing,safety
2023-12-04 14:27:06,5,64,173,335,59,103,Amazon,safety
2023-12-04 14:27:09,102,170,416,539,68,55,Youtube,safety
2023-12-04 14:27:14,129,185,255,366,56,55,Bing,data
2023-12-04 14:27:17,9,71,138,309,62,109,Amazon,data
2023-12-04 14:27:21,93,172,470,568,79,19,Youtube,data
2023-12-04 14:27:26,11,51,112,216,40,64,Bing,DDIO
2023-12-04 14:27:28,17,76,143,308,59,106,Amazon,DDIO
2023-12-04 14:27:30,78,134,322,427,56,49,Youtube,DDIO
2023-12-04 14:27:35,10,65,147,380,55,178,Bing,MSFG
2023-12-04 14:27:37,5,69,145,322,64,113,Amazon,MSFG
2023-12-04 14:27:40,86,152,408,516,66,42,Youtube,MSFG
2023-12-04 14:27:45,39,79,139,247,40,68,Bing,HOA
2023-12-04 14:27:47,12,71,140,299,59,100,Amazon,HOA
2023-12-04 14:27:50,80,160,383,493,80,30,Youtube,HOA
2023-12-04 14:27:55,13,78,162,279,65,52,Bing,FAFR
2023-12-04 14:27:57,8,66,137,323,58,128,Amazon,FAFR
2023-12-04 14:28:00,62,133,376,494,71,47,Youtube,FAFR
2023-12-04 14:28:07,48,131,207,337,83,47,Bing,WieSOichDichEmpfangen
2023-12-04 14:28:08,84,143,216,401,59,126,Amazon,WieSOichDichEmpfangen
2023-12-04 14:28:11,168,246,465,580,78,37,Youtube,WieSOichDichEmpfangen
2023-12-04 14:28:18,187,242,331,682,55,296,Bing,sagmichbitte
2023-12-04 14:28:19,6,67,305,473,61,107,Amazon,sagmichbitte
2023-12-04 14:28:22,64,117,327,431,53,51,Youtube,sagmichbitte
2023-12-04 14:28:28,12,55,126,237,43,68,Bing,ilAuraitSuffi
2023-12-04 14:28:29,10,68,138,300,58,104,Amazon,ilAuraitSuffi
2023-12-04 14:28:32,37,107,324,425,70,31,Youtube,ilAuraitSuffi
2023-12-04 14:28:47,6,45,97,254,39,118,Bing,Carnegie Mellon University
2023-12-04 14:28:49,4,63,133,283,59,91,Amazon,Carnegie Mellon University
2023-12-04 14:28:52,55,117,296,393,62,35,Youtube,Carnegie Mellon University
2023-12-04 14:28:56,123,175,245,364,52,67,Bing,Airbnb
2023-12-04 14:28:58,7,66,132,296,59,105,Amazon,Airbnb
2023-12-04 14:29:01,56,137,337,433,81,15,Youtube,Airbnb
2023-12-04 14:29:06,8,51,107,215,43,65,Bing,Facebook
2023-12-04 14:29:08,4,67,136,289,63,90,Amazon,Facebook
2023-12-04 14:29:12,82,152,369,472,70,33,Youtube,Facebook
2023-12-04 14:29:17,45,82,150,308,37,121,Bing,Youtube
2023-12-04 14:29:19,8,73,145,315,65,105,Amazon,Youtube
2023-12-04 14:29:23,92,202,601,716,110,5,Youtube,Youtube
2023-12-04 14:29:29,12,67,152,596,55,389,Bing,cirtic
2023-12-04 14:29:31,68,128,197,370,60,113,Amazon,cirtic
2023-12-04 14:29:34,66,116,333,421,50,38,Youtube,cirtic
2023-12-04 14:29:41,11,68,145,263,57,61,Bing,when would there be
2023-12-04 14:29:42,7,65,136,317,58,123,Amazon,when would there be
2023-12-04 14:29:45,68,128,349,461,60,52,Youtube,when would there be
2023-12-04 14:29:52,45,84,143,309,39,127,Bing,search the map for new
2023-12-04 14:29:53,7,68,137,301,61,103,Amazon,search the map for new
2023-12-04 14:29:58,62,121,331,414,59,24,Youtube,search the map for new
2023-12-04 14:30:04,10,48,107,221,38,76,Bing,suggestions on finals
2023-12-04 14:30:08,15,74,143,300,59,98,Amazon,suggestions on finals
2023-12-04 14:30:11,83,143,321,408,60,27,Youtube,suggestions on finals
2023-12-04 14:30:16,7,62,148,380,55,177,Bing,start
2023-12-04 14:30:19,4,65,137,315,61,117,Amazon,start
2023-12-04 14:30:21,67,131,267,376,64,45,Youtube,start
2023-12-04 14:30:26,11,64,150,317,53,114,Bing,ending
2023-12-04 14:30:28,8,79,147,325,71,107,Amazon,ending
2023-12-04 14:30:35,52,141,365,501,89,47,Youtube,ending
2023-12-04 14:30:39,11,69,130,238,58,50,Bing,safety
2023-12-04 14:30:43,7,68,140,302,61,101,Amazon,safety
2023-12-04 14:30:46,76,132,286,395,56,53,Youtube,safety
2023-12-04 14:30:51,10,54,112,262,44,106,Bing,data
2023-12-04 14:30:53,10,79,166,342,69,107,Amazon,data
2023-12-04 14:30:56,90,145,374,484,55,55,Youtube,data
2023-12-04 14:31:03,18,77,153,803,59,591,Bing,DDIO
2023-12-04 14:31:05,8,82,293,455,74,88,Amazon,DDIO
2023-12-04 14:31:09,70,141,353,451,71,27,Youtube,DDIO
2023-12-04 14:31:14,10,49,115,351,39,197,Bing,MSFG
2023-12-04 14:31:16,6,66,138,304,60,106,Amazon,MSFG
2023-12-04 14:31:19,62,131,338,438,69,31,Youtube,MSFG
2023-12-04 14:31:24,14,79,264,421,65,92,Bing,HOA
2023-12-04 14:31:26,7,69,152,315,62,101,Amazon,HOA
2023-12-04 14:31:30,65,149,427,544,84,33,Youtube,HOA
2023-12-04 14:31:35,13,75,175,287,62,50,Bing,FAFR
2023-12-04 14:31:37,7,65,146,321,58,117,Amazon,FAFR
2023-12-04 14:31:40,56,134,343,456,78,35,Youtube,FAFR
2023-12-04 14:31:45,11,53,119,234,42,73,Bing,WieSOichDichEmpfangen
2023-12-04 14:31:47,8,73,157,325,65,103,Amazon,WieSOichDichEmpfangen
2023-12-04 14:31:51,60,120,341,440,60,39,Youtube,WieSOichDichEmpfangen
2023-12-04 14:31:55,18,75,150,295,57,88,Bing,sagmichbitte
2023-12-04 14:31:57,6,71,145,306,65,96,Amazon,sagmichbitte
2023-12-04 14:32:01,66,146,351,454,80,23,Youtube,sagmichbitte
2023-12-04 14:32:05,13,58,126,286,45,115,Bing,ilAuraitSuffi
2023-12-04 14:32:07,5,70,140,402,65,197,Amazon,ilAuraitSuffi
2023-12-04 14:32:11,41,114,305,408,73,30,Youtube,ilAuraitSuffi
dateTime,connectStart,secureConnectionStart,requestStart,responseStart,networkTime,serverTime,service site,searching string
2023-12-04 14:22:06,8,47,102,253,39,112,Bing,Carnegie Mellon University
2023-12-04 14:22:08,7,64,130,296,57,109,Amazon,Carnegie Mellon University
2023-12-04 14:22:11,50,116,329,437,66,42,Youtube,Carnegie Mellon University
2023-12-04 14:22:16,54,96,155,250,42,53,Bing,Airbnb
2023-12-04 14:22:18,17,75,141,308,58,109,Amazon,Airbnb
2023-12-04 14:22:22,70,139,359,450,69,22,Youtube,Airbnb
2023-12-04 14:22:27,8,46,104,315,38,173,Bing,Facebook
2023-12-04 14:22:29,80,139,206,366,59,101,Amazon,Facebook
2023-12-04 14:22:33,51,127,404,490,76,10,Youtube,Facebook
2023-12-04 14:22:37,9,53,111,307,44,152,Bing,Youtube
2023-12-04 14:22:40,5,73,142,307,68,97,Amazon,Youtube
2023-12-04 14:22:43,92,162,447,543,70,26,Youtube,Youtube
2023-12-04 14:22:48,41,82,138,341,41,162,Bing,cirtic
2023-12-04 14:22:49,6,65,132,296,59,105,Amazon,cirtic
2023-12-04 14:22:52,79,163,400,502,84,18,Youtube,cirtic
2023-12-04 14:22:57,7,49,107,218,42,69,Bing,when would there be
2023-12-04 14:22:58,7,65,136,398,58,204,Amazon,when would there be
2023-12-04 14:23:01,63,133,389,492,70,33,Youtube,when would there be
2023-12-04 14:23:06,44,98,166,285,54,65,Bing,search the map for new
2023-12-04 14:23:08,5,68,137,298,63,98,Amazon,search the map for new
2023-12-04 14:23:11,57,146,369,495,89,37,Youtube,search the map for new
2023-12-04 14:23:16,7,61,133,460,54,273,Bing,suggestions on finals
2023-12-04 14:23:18,8,66,131,297,58,108,Amazon,suggestions on finals
2023-12-04 14:23:21,65,147,406,491,82,3,Youtube,suggestions on finals
2023-12-04 14:23:26,6,61,132,393,55,206,Bing,start
2023-12-04 14:23:28,7,65,133,290,58,99,Amazon,start
2023-12-04 14:23:32,54,123,341,447,69,37,Youtube,start
2023-12-04 14:23:37,10,65,168,304,55,81,Bing,ending
2023-12-04 14:23:40,5,65,139,292,60,93,Amazon,ending
2023-12-04 14:23:44,64,137,402,496,73,21,Youtube,ending
2023-12-04 14:23:48,7,49,105,285,42,138,Bing,safety
2023-12-04 14:23:50,223,281,347,514,58,109,Amazon,safety
2023-12-04 14:23:55,79,162,1020,1149,83,46,Youtube,safety
2023-12-04 14:23:59,59,113,201,317,54,62,Bing,data
2023-12-04 14:24:01,10,67,132,303,57,114,Amazon,data
2023-12-04 14:24:06,113,177,459,566,64,43,Youtube,data
2023-12-04 14:24:11,80,192,271,517,112,134,Bing,DDIO
2023-12-04 14:24:12,5,63,134,296,58,104,Amazon,DDIO
2023-12-04 14:24:15,66,134,353,463,68,42,Youtube,DDIO
2023-12-04 14:24:20,8,61,141,299,53,105,Bing,MSFG
2023-12-04 14:24:22,10,71,139,294,61,94,Amazon,MSFG
2023-12-04 14:24:24,84,158,385,523,74,64,Youtube,MSFG
2023-12-04 14:24:30,10,50,113,211,40,58,Bing,HOA
2023-12-04 14:24:32,7,69,138,306,62,106,Amazon,HOA
2023-12-04 14:24:35,72,150,374,466,78,14,Youtube,HOA
2023-12-04 14:24:40,9,65,147,270,56,67,Bing,FAFR
2023-12-04 14:24:42,6,65,132,294,59,103,Amazon,FAFR
2023-12-04 14:24:45,66,136,365,465,70,30,Youtube,FAFR
2023-12-04 14:24:50,41,83,142,460,42,276,Bing,WieSOichDichEmpfangen
2023-12-04 14:24:52,9,74,146,330,65,119,Amazon,WieSOichDichEmpfangen
2023-12-04 14:24:55,53,123,352,461,70,39,Youtube,WieSOichDichEmpfangen
2023-12-04 14:25:00,7,48,101,251,41,109,Bing,sagmichbitte
2023-12-04 14:25:01,4,66,135,289,62,92,Amazon,sagmichbitte
2023-12-04 14:25:05,54,123,326,432,69,37,Youtube,sagmichbitte
2023-12-04 14:25:09,39,77,141,271,38,92,Bing,ilAuraitSuffi
2023-12-04 14:25:11,41,104,176,332,63,93,Amazon,ilAuraitSuffi
2023-12-04 14:25:14,39,110,329,435,71,35,Youtube,ilAuraitSuffi
2023-12-04 14:25:29,39,80,137,252,41,74,Bing,Carnegie Mellon University
2023-12-04 14:25:34,56,114,182,348,58,108,Amazon,Carnegie Mellon University
2023-12-04 14:25:43,9,51,103,212,42,67,Bing,Airbnb
2023-12-04 14:25:44,6,65,132,296,59,105,Amazon,Airbnb
2023-12-04 14:25:47,83,160,404,499,77,18,Youtube,Airbnb
2023-12-04 14:25:53,53,107,396,717,54,267,Bing,Facebook
2023-12-04 14:25:54,6,65,132,313,59,122,Amazon,Facebook
2023-12-04 14:25:57,76,144,368,468,68,32,Youtube,Facebook
2023-12-04 14:26:02,9,49,105,203,40,58,Bing,Youtube
2023-12-04 14:26:04,1701717962587,1701717962650,1701717962715,1701717962882,63,104,Amazon,Youtube
2023-12-04 14:26:06,55,110,285,380,55,40,Youtube,Youtube
2023-12-04 14:26:11,42,80,139,259,38,82,Bing,cirtic
2023-12-04 14:26:13,9,69,142,374,60,172,Amazon,cirtic
2023-12-04 14:26:17,69,141,359,459,72,28,Youtube,cirtic
2023-12-04 14:26:22,9,64,138,259,55,66,Bing,when would there be
2023-12-04 14:26:24,11,73,142,303,62,99,Amazon,when would there be
2023-12-04 14:26:28,49,121,380,489,72,37,Youtube,when would there be
2023-12-04 14:26:33,41,96,168,307,55,84,Bing,search the map for new
2023-12-04 14:26:35,8,67,137,296,59,100,Amazon,search the map for new
2023-12-04 14:26:37,51,104,314,400,53,33,Youtube,search the map for new
2023-12-04 14:26:42,12,68,145,271,56,70,Bing,suggestions on finals
2023-12-04 14:26:44,6,65,130,290,59,101,Amazon,suggestions on finals
2023-12-04 14:26:48,105,171,373,480,66,41,Youtube,suggestions on finals
2023-12-04 14:26:53,53,109,184,429,56,189,Bing,start
2023-12-04 14:26:55,10,70,137,307,60,110,Amazon,start
2023-12-04 14:26:59,62,136,346,455,74,35,Youtube,start
2023-12-04 14:27:04,10,49,115,275,39,121,Bing,ending
2023-12-04 14:27:06,4,65,136,301,61,104,Amazon,ending
2023-12-04 14:27:09,100,168,397,499,68,34,Youtube,ending
2023-12-04 14:27:15,12,72,144,390,60,186,Bing,safety
2023-12-04 14:27:17,8,68,138,308,60,110,Amazon,safety
2023-12-04 14:27:20,82,155,360,466,73,33,Youtube,safety
2023-12-04 14:27:25,11,65,139,446,54,253,Bing,data
2023-12-04 14:27:28,7,71,140,309,64,105,Amazon,data
2023-12-04 14:27:30,111,183,424,539,72,43,Youtube,data
2023-12-04 14:27:36,11,56,119,243,45,79,Bing,DDIO
2023-12-04 14:27:38,10,72,151,319,62,106,Amazon,DDIO
2023-12-04 14:27:41,75,132,360,447,57,30,Youtube,DDIO
2023-12-04 14:27:46,11,51,115,235,40,80,Bing,MSFG
2023-12-04 14:27:48,6,66,135,304,60,109,Amazon,MSFG
2023-12-04 14:27:51,79,160,416,522,81,25,Youtube,MSFG
2023-12-04 14:27:57,14,129,257,385,115,13,Bing,HOA
2023-12-04 14:27:59,10,74,151,345,64,130,Amazon,HOA
2023-12-04 14:28:03,94,157,350,438,63,25,Youtube,HOA
2023-12-04 14:28:09,15,132,212,499,117,170,Bing,FAFR
2023-12-04 14:28:11,13,82,156,320,69,95,Amazon,FAFR
2023-12-04 14:28:16,112,179,414,510,67,29,Youtube,FAFR
2023-12-04 14:28:21,16,74,154,278,58,66,Bing,WieSOichDichEmpfangen
2023-12-04 14:28:22,5,64,133,297,59,105,Amazon,WieSOichDichEmpfangen
2023-12-04 14:28:27,61,128,710,845,67,68,Youtube,WieSOichDichEmpfangen
2023-12-04 14:28:32,10,68,148,264,58,58,Bing,sagmichbitte
2023-12-04 14:28:33,5,62,133,288,57,98,Amazon,sagmichbitte
2023-12-04 14:28:36,60,122,310,413,62,41,Youtube,sagmichbitte
2023-12-04 14:28:40,6,60,131,241,54,56,Bing,ilAuraitSuffi
2023-12-04 14:28:42,5,64,132,295,59,104,Amazon,ilAuraitSuffi
2023-12-04 14:28:44,37,104,324,430,67,39,Youtube,ilAuraitSuffi
2023-12-04 14:28:59,11,70,141,327,59,127,Bing,Carnegie Mellon University
2023-12-04 14:29:01,6,66,135,293,60,98,Amazon,Carnegie Mellon University
2023-12-04 14:29:03,121,178,396,488,57,35,Youtube,Carnegie Mellon University
2023-12-04 14:29:09,15,77,148,273,62,63,Bing,Airbnb
2023-12-04 14:29:10,5,66,148,324,61,115,Amazon,Airbnb
2023-12-04 14:29:13,63,133,349,469,70,50,Youtube,Airbnb
2023-12-04 14:29:19,14,72,156,666,58,452,Bing,Facebook
2023-12-04 14:29:22,14,88,159,323,74,90,Amazon,Facebook
2023-12-04 14:29:26,68,121,336,424,53,35,Youtube,Facebook
2023-12-04 14:29:32,24,97,182,802,73,547,Bing,Youtube
2023-12-04 14:29:34,10,75,143,292,65,84,Amazon,Youtube
2023-12-04 14:29:38,108,180,380,466,72,14,Youtube,Youtube
2023-12-04 14:29:44,21,69,137,298,48,113,Bing,cirtic
2023-12-04 14:29:45,6,64,134,302,58,110,Amazon,cirtic
2023-12-04 14:29:49,69,123,313,407,54,40,Youtube,cirtic
2023-12-04 14:29:55,16,81,159,309,65,85,Bing,when would there be
2023-12-04 14:29:57,6,63,137,306,57,112,Amazon,when would there be
2023-12-04 14:30:01,82,186,416,526,104,6,Youtube,when would there be
2023-12-04 14:30:06,9,63,133,244,54,57,Bing,search the map for new
2023-12-04 14:30:08,8,66,133,295,58,104,Amazon,search the map for new
2023-12-04 14:30:11,81,152,389,501,71,41,Youtube,search the map for new
2023-12-04 14:30:16,70,128,205,371,58,108,Bing,suggestions on finals
2023-12-04 14:30:18,8,68,140,297,60,97,Amazon,suggestions on finals
2023-12-04 14:30:22,52,120,344,444,68,32,Youtube,suggestions on finals
2023-12-04 14:30:27,11,69,145,305,58,102,Bing,start
2023-12-04 14:30:29,10,74,164,364,64,136,Amazon,start
2023-12-04 14:30:34,73,143,349,454,70,35,Youtube,start
2023-12-04 14:30:39,56,94,160,256,38,58,Bing,ending
2023-12-04 14:30:41,9,69,145,306,60,101,Amazon,ending
2023-12-04 14:30:45,74,141,321,416,67,28,Youtube,ending
2023-12-04 14:30:50,10,70,151,276,60,65,Bing,safety
2023-12-04 14:30:52,85,143,212,374,58,104,Amazon,safety
2023-12-04 14:30:55,112,175,460,565,63,42,Youtube,safety
2023-12-04 14:31:01,11,53,183,502,42,277,Bing,data
2023-12-04 14:31:03,10,72,146,312,62,104,Amazon,data
2023-12-04 14:31:08,167,238,504,631,71,56,Youtube,data
2023-12-04 14:31:13,9,67,138,259,58,63,Bing,DDIO
2023-12-04 14:31:14,9,69,143,303,60,100,Amazon,DDIO
2023-12-04 14:31:17,63,119,359,450,56,35,Youtube,DDIO
2023-12-04 14:31:22,7,48,139,385,41,205,Bing,MSFG
2023-12-04 14:31:24,8,66,134,299,58,107,Amazon,MSFG
2023-12-04 14:31:28,59,131,351,458,72,35,Youtube,MSFG
2023-12-04 14:31:34,155,209,286,648,54,308,Bing,HOA
2023-12-04 14:31:35,10,72,226,391,62,103,Amazon,HOA
2023-12-04 14:31:38,87,165,370,476,78,28,Youtube,HOA
2023-12-04 14:31:45,10,54,114,872,44,714,Bing,FAFR
2023-12-04 14:31:46,7,74,154,313,67,92,Amazon,FAFR
2023-12-04 14:31:50,89,176,392,498,87,19,Youtube,FAFR
2023-12-04 14:31:55,51,92,159,265,41,65,Bing,WieSOichDichEmpfangen
2023-12-04 14:31:57,7,69,142,310,62,106,Amazon,WieSOichDichEmpfangen
2023-12-04 14:32:00,68,137,373,476,69,34,Youtube,WieSOichDichEmpfangen
2023-12-04 14:32:05,10,65,142,293,55,96,Bing,sagmichbitte
2023-12-04 14:32:06,5,68,137,297,63,97,Amazon,sagmichbitte
2023-12-04 14:32:09,60,132,413,517,72,32,Youtube,sagmichbitte
2023-12-04 14:32:15,9,62,131,368,53,184,Bing,ilAuraitSuffi
2023-12-04 14:32:16,69,127,193,352,58,101,Amazon,ilAuraitSuffi
2023-12-04 14:32:19,32,114,366,468,82,20,Youtube,ilAuraitSuffi
