dateTime,connectStart,secureConnectionStart,requestStart,responseStart,networkTime,serverTime,service site,searching string
2023-12-04 22:02:59,408,719,1051,1551,311,189,Bing,Carnegie Mellon University
2023-12-04 22:03:04,300,449,620,1172,149,403,Amazon,Carnegie Mellon University
2023-12-04 22:03:09,196,364,744,963,168,51,Youtube,Carnegie Mellon University
2023-12-04 22:03:19,10,323,651,1158,313,194,Bing,Airbnb
2023-12-04 22:03:22,6,154,312,624,148,164,Amazon,Airbnb
2023-12-04 22:03:26,50,215,589,782,165,28,Youtube,Airbnb
2023-12-04 22:03:33,503,812,1138,1656,309,209,Bing,Facebook
2023-12-04 22:03:35,8,158,319,632,150,163,Amazon,Facebook
2023-12-04 22:03:40,47,211,757,960,164,39,Youtube,Facebook
2023-12-04 22:03:49,6,6,954,1577,0,623,Bing,Youtube
2023-12-04 22:03:53,6,311,469,839,305,65,Amazon,Youtube
2023-12-04 22:04:00,442,617,1060,1468,175,233,Youtube,Youtube
2023-12-04 22:04:05,308,615,939,1436,307,190,Bing,cirtic
2023-12-04 22:04:08,8,156,316,635,148,171,Amazon,cirtic
2023-12-04 22:04:13,43,209,766,968,166,36,Youtube,cirtic
2023-12-04 22:04:19,237,541,857,1362,304,201,Bing,when would there be
2023-12-04 22:04:24,247,399,558,888,152,178,Amazon,when would there be
2023-12-04 22:04:31,58,220,1003,1203,162,38,Youtube,when would there be
2023-12-04 22:04:37,7,324,676,1317,317,324,Bing,search the map for new
2023-12-04 22:04:40,6,241,407,892,235,250,Amazon,search the map for new
2023-12-04 22:04:51,316,631,968,1473,315,190,Bing,suggestions on finals
2023-12-04 22:04:55,7,155,311,637,148,178,Amazon,suggestions on finals
2023-12-04 22:05:00,42,216,783,982,174,25,Youtube,suggestions on finals
2023-12-04 22:05:05,6,306,633,1115,300,182,Bing,start
2023-12-04 22:05:08,7,156,314,945,149,482,Amazon,start
2023-12-04 22:05:13,50,212,767,972,162,43,Youtube,start
2023-12-04 22:05:19,332,644,979,1494,312,203,Bing,ending
2023-12-04 22:05:22,6,158,320,671,152,199,Amazon,ending
2023-12-04 22:05:28,43,213,1179,1376,170,27,Youtube,ending
2023-12-04 22:05:33,7,312,633,1132,305,194,Bing,safety
2023-12-04 22:05:37,8,156,321,664,148,195,Amazon,safety
2023-12-04 22:05:42,54,218,614,840,164,62,Youtube,safety
2023-12-04 22:05:48,473,861,1401,1915,388,126,Bing,data
2023-12-04 22:05:53,499,650,908,1420,151,361,Amazon,data
2023-12-04 22:05:58,44,377,999,1426,333,94,Youtube,data
2023-12-04 22:06:04,6,347,763,1399,341,295,Bing,DDIO
2023-12-04 22:06:08,16,254,417,1078,238,423,Amazon,DDIO
2023-12-04 22:06:14,44,208,1219,1428,164,45,Youtube,DDIO
2023-12-04 22:06:20,309,619,955,1451,310,186,Bing,MSFG
2023-12-04 22:06:24,7,294,461,818,287,70,Amazon,MSFG
2023-12-04 22:06:33,252,252,1529,1747,0,218,Youtube,MSFG
2023-12-04 22:06:39,6,371,793,1446,365,288,Bing,HOA
2023-12-04 22:06:43,8,157,318,633,149,166,Amazon,HOA
2023-12-04 22:06:49,43,232,1009,1222,189,24,Youtube,HOA
2023-12-04 22:06:55,423,728,1051,1538,305,182,Bing,FAFR
2023-12-04 22:06:58,7,159,323,652,152,177,Amazon,FAFR
2023-12-04 22:07:05,43,212,777,972,169,26,Youtube,FAFR
2023-12-04 22:07:12,307,698,1188,1834,391,255,Bing,WieSOichDichEmpfangen
2023-12-04 22:07:16,202,506,685,1029,304,40,Amazon,WieSOichDichEmpfangen
2023-12-04 22:07:20,36,208,886,1087,172,29,Youtube,WieSOichDichEmpfangen
2023-12-04 22:07:26,6,384,708,1213,378,127,Bing,sagmichbitte
2023-12-04 22:07:29,7,249,413,905,242,250,Amazon,sagmichbitte
2023-12-04 22:07:40,6,316,644,1133,310,179,Bing,ilAuraitSuffi
2023-12-04 22:07:43,6,157,315,649,151,183,Amazon,ilAuraitSuffi
2023-12-04 22:07:48,35,199,747,943,164,32,Youtube,ilAuraitSuffi
2023-12-04 22:08:05,318,633,966,1519,315,238,Bing,Carnegie Mellon University
2023-12-04 22:08:09,5,163,333,961,158,470,Amazon,Carnegie Mellon University
2023-12-04 22:08:14,48,211,588,792,163,41,Youtube,Carnegie Mellon University
2023-12-04 22:08:19,246,551,882,1400,305,213,Bing,Airbnb
2023-12-04 22:08:25,6,162,321,644,156,167,Amazon,Airbnb
2023-12-04 22:08:28,48,216,592,791,168,31,Youtube,Airbnb
2023-12-04 22:08:34,6,313,638,1132,307,187,Bing,Facebook
2023-12-04 22:08:38,467,622,781,1432,155,496,Amazon,Facebook
2023-12-04 22:08:43,57,224,761,958,167,30,Youtube,Facebook
2023-12-04 22:08:48,6,305,626,1134,299,209,Bing,Youtube
2023-12-04 22:08:52,9,157,313,950,148,489,Amazon,Youtube
2023-12-04 22:08:57,42,206,588,793,164,41,Youtube,Youtube
2023-12-04 22:09:02,7,307,628,1408,300,480,Bing,cirtic
2023-12-04 22:09:05,8,156,319,657,148,190,Amazon,cirtic
2023-12-04 22:09:10,35,200,752,947,165,30,Youtube,cirtic
2023-12-04 22:09:15,7,310,641,1147,303,203,Bing,when would there be
2023-12-04 22:09:18,7,155,314,648,148,186,Amazon,when would there be
2023-12-04 22:09:23,43,211,765,959,168,26,Youtube,when would there be
2023-12-04 22:09:28,7,317,644,1150,310,196,Bing,search the map for new
2023-12-04 22:09:31,17,175,332,654,158,164,Amazon,search the map for new
2023-12-04 22:09:36,44,205,754,956,161,41,Youtube,search the map for new
2023-12-04 22:09:41,425,732,1067,1567,307,193,Bing,suggestions on finals
2023-12-04 22:09:44,10,162,322,644,152,170,Amazon,suggestions on finals
2023-12-04 22:09:49,47,211,773,969,164,32,Youtube,suggestions on finals
2023-12-04 22:09:54,7,312,636,1124,305,183,Bing,start
2023-12-04 22:09:58,454,604,767,1097,150,180,Amazon,start
2023-12-04 22:10:03,47,213,924,1125,166,35,Youtube,start
2023-12-04 22:10:08,7,316,643,1148,309,196,Bing,ending
2023-12-04 22:10:12,8,156,326,961,148,487,Amazon,ending
2023-12-04 22:10:24,515,830,1176,1689,315,198,Bing,safety
2023-12-04 22:10:27,5,156,314,647,151,182,Amazon,safety
2023-12-04 22:10:31,52,217,604,802,165,33,Youtube,safety
2023-12-04 22:10:37,7,315,649,1140,308,183,Bing,data
2023-12-04 22:10:40,11,160,322,957,149,486,Amazon,data
2023-12-04 22:10:45,49,213,597,819,164,58,Youtube,data
2023-12-04 22:10:51,145,459,784,1278,314,180,Bing,DDIO
2023-12-04 22:10:54,8,156,315,640,148,177,Amazon,DDIO
2023-12-04 22:10:59,45,211,761,965,166,38,Youtube,DDIO
2023-12-04 22:11:04,143,439,761,1240,296,183,Bing,MSFG
2023-12-04 22:11:07,14,162,321,641,148,172,Amazon,MSFG
2023-12-04 22:11:11,41,202,750,994,161,83,Youtube,MSFG
2023-12-04 22:11:16,6,306,621,1112,300,191,Bing,HOA
2023-12-04 22:11:19,208,357,517,849,149,183,Amazon,HOA
2023-12-04 22:11:24,44,208,753,951,164,34,Youtube,HOA
2023-12-04 22:11:30,6,313,637,1135,307,191,Bing,FAFR
2023-12-04 22:11:32,8,160,324,644,152,168,Amazon,FAFR
2023-12-04 22:11:37,43,206,752,948,163,33,Youtube,FAFR
2023-12-04 22:11:43,6,317,653,1158,311,194,Bing,WieSOichDichEmpfangen
2023-12-04 22:11:46,6,157,319,631,151,161,Amazon,WieSOichDichEmpfangen
2023-12-04 22:11:51,32,195,1169,1366,163,34,Youtube,WieSOichDichEmpfangen
2023-12-04 22:11:56,7,314,653,1147,307,187,Bing,sagmichbitte
2023-12-04 22:11:59,10,164,324,647,154,169,Amazon,sagmichbitte
2023-12-04 22:12:04,43,205,746,963,162,55,Youtube,sagmichbitte
2023-12-04 22:12:09,142,443,758,1244,301,185,Bing,ilAuraitSuffi
2023-12-04 22:12:12,5,156,323,641,151,167,Amazon,ilAuraitSuffi
2023-12-04 22:12:17,35,197,744,948,162,42,Youtube,ilAuraitSuffi
2023-12-04 22:12:33,6,311,635,1126,305,186,Bing,Carnegie Mellon University
2023-12-04 22:12:37,5,157,318,633,152,163,Amazon,Carnegie Mellon University
2023-12-04 22:12:41,50,215,593,828,165,70,Youtube,Carnegie Mellon University
2023-12-04 22:12:47,4,302,621,1132,298,213,Bing,Airbnb
2023-12-04 22:12:50,11,163,321,645,152,172,Amazon,Airbnb
2023-12-04 22:12:54,46,211,599,806,165,42,Youtube,Airbnb
2023-12-04 22:13:00,7,327,663,1187,320,204,Bing,Facebook
2023-12-04 22:13:03,4,158,319,640,154,167,Amazon,Facebook
2023-12-04 22:13:10,52,217,769,981,165,47,Youtube,Facebook
2023-12-04 22:13:21,4,153,317,992,149,526,Amazon,Youtube
2023-12-04 22:13:28,51,223,884,1127,172,71,Youtube,Youtube
2023-12-04 22:13:34,453,759,1124,1629,306,199,Bing,cirtic
2023-12-04 22:13:38,12,164,349,669,152,168,Amazon,cirtic
2023-12-04 22:13:43,36,201,774,973,165,34,Youtube,cirtic
2023-12-04 22:13:50,7,7,1304,1812,0,508,Bing,when would there be
2023-12-04 22:13:54,7,157,451,966,150,365,Amazon,when would there be
2023-12-04 22:14:02,41,214,1057,1252,173,22,Youtube,when would there be
2023-12-04 22:14:07,7,307,707,1334,300,327,Bing,search the map for new
2023-12-04 22:14:11,262,411,571,918,149,198,Amazon,search the map for new
2023-12-04 22:14:19,44,313,1083,1363,269,11,Youtube,search the map for new
2023-12-04 22:14:24,484,787,1114,1608,303,191,Bing,suggestions on finals
2023-12-04 22:14:28,14,163,325,971,149,497,Amazon,suggestions on finals
2023-12-04 22:14:32,45,210,754,968,165,49,Youtube,suggestions on finals
2023-12-04 22:14:38,7,306,628,1110,299,183,Bing,start
2023-12-04 22:14:41,10,160,322,642,150,170,Amazon,start
2023-12-04 22:14:46,47,209,771,969,162,36,Youtube,start
2023-12-04 22:14:52,347,651,973,1459,304,182,Bing,ending
2023-12-04 22:14:56,8,160,319,631,152,160,Amazon,ending
2023-12-04 22:15:01,51,215,876,1079,164,39,Youtube,ending
2023-12-04 22:15:06,6,316,655,1315,310,350,Bing,safety
2023-12-04 22:15:10,14,162,323,661,148,190,Amazon,safety
2023-12-04 22:15:23,330,635,964,1455,305,186,Bing,data
2023-12-04 22:15:26,6,157,322,652,151,179,Amazon,data
2023-12-04 22:15:31,52,218,597,796,166,33,Youtube,data
2023-12-04 22:15:37,6,313,638,1708,307,763,Bing,DDIO
2023-12-04 22:15:40,18,167,326,957,149,482,Amazon,DDIO
2023-12-04 22:15:45,42,206,757,952,164,31,Youtube,DDIO
2023-12-04 22:15:50,6,304,625,1115,298,192,Bing,MSFG
2023-12-04 22:15:53,8,168,329,650,160,161,Amazon,MSFG
2023-12-04 22:15:58,44,208,760,971,164,47,Youtube,MSFG
2023-12-04 22:16:04,5,312,640,1234,307,287,Bing,HOA
2023-12-04 22:16:08,6,459,648,1442,453,341,Amazon,HOA
2023-12-04 22:16:15,42,207,992,1188,165,31,Youtube,HOA
2023-12-04 22:16:21,422,422,1425,1925,0,500,Bing,FAFR
2023-12-04 22:16:24,6,160,326,653,154,173,Amazon,FAFR
2023-12-04 22:16:30,49,220,1016,1239,171,52,Youtube,FAFR
2023-12-04 22:16:35,7,318,660,1154,311,183,Bing,WieSOichDichEmpfangen
2023-12-04 22:16:38,9,162,322,644,153,169,Amazon,WieSOichDichEmpfangen
2023-12-04 22:16:43,35,199,759,962,164,39,Youtube,WieSOichDichEmpfangen
2023-12-04 22:16:49,7,316,649,1153,309,195,Bing,sagmichbitte
2023-12-04 22:16:52,264,416,586,905,152,167,Amazon,sagmichbitte
2023-12-04 22:16:57,51,216,766,973,165,42,Youtube,sagmichbitte
2023-12-04 22:17:02,7,309,635,1145,302,208,Bing,ilAuraitSuffi
2023-12-04 22:17:05,10,165,324,651,155,172,Amazon,ilAuraitSuffi
2023-12-04 22:17:09,27,193,745,958,166,47,Youtube,ilAuraitSuffi
