dateTime,connectStart,secureConnectionStart,requestStart,responseStart,networkTime,serverTime,service site,searching string
2023-12-04 19:19:41,33,55,106,191,22,63,Bing,Carnegie Mellon University
2023-12-04 19:19:43,30,51,86,204,21,97,Amazon,Carnegie Mellon University
2023-12-04 19:19:46,92,115,266,631,23,342,Youtube,Carnegie Mellon University
2023-12-04 19:19:51,10,32,89,189,22,78,Bing,Airbnb
2023-12-04 19:19:54,22,44,78,180,22,80,Amazon,Airbnb
2023-12-04 19:19:58,60,85,510,584,25,49,Youtube,Airbnb
2023-12-04 19:20:05,8,30,180,1268,22,1066,Bing,Facebook
2023-12-04 19:20:08,52,104,139,236,52,45,Amazon,Facebook
2023-12-04 19:20:11,63,86,272,368,23,73,Youtube,Facebook
2023-12-04 19:20:16,6,27,310,393,21,62,Bing,Youtube
2023-12-04 19:20:23,61,83,245,318,22,51,Youtube,Youtube
2023-12-04 19:20:28,9,29,79,240,20,141,Bing,cirtic
2023-12-04 19:20:36,54,76,233,297,22,42,Youtube,cirtic
2023-12-04 19:20:44,11,41,1422,1509,30,57,Bing,when would there be
2023-12-04 19:20:46,5,26,55,153,21,77,Amazon,when would there be
2023-12-04 19:20:50,62,86,250,321,24,47,Youtube,when would there be
2023-12-04 19:20:55,6,30,87,173,24,62,Bing,search the map for new
2023-12-04 19:20:59,26,53,89,219,27,103,Amazon,search the map for new
2023-12-04 19:21:02,83,110,265,327,27,35,Youtube,search the map for new
2023-12-04 19:21:07,27,52,105,201,25,71,Bing,suggestions on finals
2023-12-04 19:21:11,6,30,99,204,24,81,Amazon,suggestions on finals
2023-12-04 19:21:16,68,93,263,332,25,44,Youtube,suggestions on finals
2023-12-04 19:21:21,17,40,93,178,23,62,Bing,start
2023-12-04 19:21:25,13,39,72,166,26,68,Amazon,start
2023-12-04 19:21:33,50,74,233,642,24,385,Youtube,start
2023-12-04 19:21:37,7,32,87,171,25,59,Bing,ending
2023-12-04 19:21:40,6,32,62,156,26,68,Amazon,ending
2023-12-04 19:21:42,49,71,243,311,22,46,Youtube,ending
2023-12-04 19:21:47,6,28,76,146,22,48,Bing,safety
2023-12-04 19:21:54,13,34,66,178,21,91,Amazon,safety
2023-12-04 19:21:58,55,81,215,282,26,41,Youtube,safety
2023-12-04 19:22:03,9,31,88,154,22,44,Bing,data
2023-12-04 19:22:09,56,79,244,311,23,44,Youtube,data
2023-12-04 19:22:14,8,31,83,181,23,75,Bing,DDIO
2023-12-04 19:22:17,14,38,70,209,24,115,Amazon,DDIO
2023-12-04 19:22:20,62,85,254,320,23,43,Youtube,DDIO
2023-12-04 19:22:25,7,29,79,143,22,42,Bing,MSFG
2023-12-04 19:22:29,17,40,72,221,23,126,Amazon,MSFG
2023-12-04 19:22:32,74,96,261,324,22,41,Youtube,MSFG
2023-12-04 19:22:38,16,40,96,170,24,50,Bing,HOA
2023-12-04 19:22:41,6,28,60,167,22,85,Amazon,HOA
2023-12-04 19:22:46,148,170,332,411,22,57,Youtube,HOA
2023-12-04 19:22:50,9,33,114,193,24,55,Bing,FAFR
2023-12-04 19:22:54,3074,3098,3141,3241,24,76,Amazon,FAFR
2023-12-04 19:22:58,46,68,221,290,22,47,Youtube,FAFR
2023-12-04 19:23:02,7,29,77,141,22,42,Bing,WieSOichDichEmpfangen
2023-12-04 19:23:04,7,34,67,184,27,90,Amazon,WieSOichDichEmpfangen
2023-12-04 19:23:11,10,31,79,146,21,46,Bing,sagmichbitte
2023-12-04 19:23:14,11,33,63,160,22,75,Amazon,sagmichbitte
2023-12-04 19:23:16,45,66,220,295,21,54,Youtube,sagmichbitte
2023-12-04 19:23:20,56,76,136,204,20,48,Bing,ilAuraitSuffi
2023-12-04 19:23:22,6,31,62,162,25,75,Amazon,ilAuraitSuffi
2023-12-04 19:23:25,60,82,240,314,22,52,Youtube,ilAuraitSuffi
2023-12-04 19:23:39,9,30,82,152,21,49,Bing,Carnegie Mellon University
2023-12-04 19:23:41,28,50,81,194,22,91,Amazon,Carnegie Mellon University
2023-12-04 19:23:45,50,72,511,616,22,83,Youtube,Carnegie Mellon University
2023-12-04 19:23:49,7,29,77,145,22,46,Bing,Airbnb
2023-12-04 19:23:56,4,84,323,423,80,20,Amazon,Airbnb
2023-12-04 19:23:58,41,63,211,268,22,35,Youtube,Airbnb
2023-12-04 19:24:03,9,30,112,181,21,48,Bing,Facebook
2023-12-04 19:24:06,19,40,72,247,21,154,Amazon,Facebook
2023-12-04 19:24:08,50,71,199,267,21,47,Youtube,Facebook
2023-12-04 19:24:13,8,28,78,140,20,42,Bing,Youtube
2023-12-04 19:24:16,6,28,64,237,22,151,Amazon,Youtube
2023-12-04 19:24:19,70,93,255,341,23,63,Youtube,Youtube
2023-12-04 19:24:23,9,31,81,144,22,41,Bing,cirtic
2023-12-04 19:24:26,11,34,64,156,23,69,Amazon,cirtic
2023-12-04 19:24:34,6,28,81,145,22,42,Bing,when would there be
2023-12-04 19:24:42,56,84,553,623,28,42,Youtube,when would there be
2023-12-04 19:24:46,8,29,82,150,21,47,Bing,search the map for new
2023-12-04 19:24:49,8,30,63,161,22,76,Amazon,search the map for new
2023-12-04 19:24:53,57,84,283,419,27,109,Youtube,search the map for new
2023-12-04 19:24:57,7,28,80,145,21,44,Bing,suggestions on finals
2023-12-04 19:24:59,31,53,86,212,22,104,Amazon,suggestions on finals
2023-12-04 19:25:03,52,75,232,310,23,55,Youtube,suggestions on finals
2023-12-04 19:25:14,17,40,95,160,23,42,Bing,start
2023-12-04 19:25:16,5,27,60,222,22,140,Amazon,start
2023-12-04 19:25:19,57,79,235,302,22,45,Youtube,start
2023-12-04 19:25:23,8,27,79,147,19,49,Bing,ending
2023-12-04 19:25:25,59,81,112,201,22,67,Amazon,ending
2023-12-04 19:25:30,57,85,287,362,28,47,Youtube,ending
2023-12-04 19:25:35,85,167,228,337,82,27,Bing,safety
2023-12-04 19:25:36,6,28,58,176,22,96,Amazon,safety
2023-12-04 19:25:40,65,87,248,348,22,78,Youtube,safety
2023-12-04 19:25:45,9,30,85,157,21,51,Bing,data
2023-12-04 19:25:47,8,30,61,164,22,81,Amazon,data
2023-12-04 19:25:50,45,69,225,335,24,86,Youtube,data
2023-12-04 19:25:56,12,34,85,152,22,45,Bing,DDIO
2023-12-04 19:25:58,16,40,71,174,24,79,Amazon,DDIO
2023-12-04 19:26:02,55,79,573,655,24,58,Youtube,DDIO
2023-12-04 19:26:07,10,33,97,163,23,43,Bing,MSFG
2023-12-04 19:26:08,11,31,64,175,20,91,Amazon,MSFG
2023-12-04 19:26:14,67,91,811,881,24,46,Youtube,MSFG
2023-12-04 19:26:19,9,29,86,154,20,48,Bing,HOA
2023-12-04 19:26:21,55,76,111,211,21,79,Amazon,HOA
2023-12-04 19:26:25,59,85,506,587,26,55,Youtube,HOA
2023-12-04 19:26:30,9,32,80,144,23,41,Bing,FAFR
2023-12-04 19:26:31,10,31,59,147,21,67,Amazon,FAFR
2023-12-04 19:26:36,57,79,456,538,22,60,Youtube,FAFR
2023-12-04 19:26:41,12,33,89,155,21,45,Bing,WieSOichDichEmpfangen
2023-12-04 19:26:44,8,32,62,153,24,67,Amazon,WieSOichDichEmpfangen
2023-12-04 19:26:48,47,68,224,303,21,58,Youtube,WieSOichDichEmpfangen
2023-12-04 19:26:52,8,29,78,144,21,45,Bing,sagmichbitte
2023-12-04 19:26:55,8,32,65,183,24,94,Amazon,sagmichbitte
2023-12-04 19:26:58,64,86,250,314,22,42,Youtube,sagmichbitte
2023-12-04 19:27:02,5,26,77,142,21,44,Bing,ilAuraitSuffi
2023-12-04 19:27:04,15,37,73,190,22,95,Amazon,ilAuraitSuffi
2023-12-04 19:27:08,37,61,218,292,24,50,Youtube,ilAuraitSuffi
2023-12-04 19:27:23,8,28,78,143,20,45,Bing,Carnegie Mellon University
2023-12-04 19:27:26,33,55,89,215,22,104,Amazon,Carnegie Mellon University
2023-12-04 19:27:31,81,103,237,313,22,54,Youtube,Carnegie Mellon University
2023-12-04 19:27:35,6,29,78,147,23,46,Bing,Airbnb
2023-12-04 19:27:37,44,70,100,195,26,69,Amazon,Airbnb
2023-12-04 19:27:41,97,118,276,351,21,54,Youtube,Airbnb
2023-12-04 19:27:46,26,47,433,515,21,61,Bing,Facebook
2023-12-04 19:27:49,14,36,70,166,22,74,Amazon,Facebook
2023-12-04 19:27:52,79,102,242,316,23,51,Youtube,Facebook
2023-12-04 19:27:58,14,35,100,167,21,46,Bing,Youtube
2023-12-04 19:28:01,7,29,61,166,22,83,Amazon,Youtube
2023-12-04 19:28:05,74,97,249,320,23,48,Youtube,Youtube
2023-12-04 19:28:10,10,32,83,146,22,41,Bing,cirtic
2023-12-04 19:28:13,32,54,84,200,22,94,Amazon,cirtic
2023-12-04 19:28:16,53,76,231,305,23,51,Youtube,cirtic
2023-12-04 19:28:20,6,27,76,143,21,46,Bing,when would there be
2023-12-04 19:28:22,31,52,86,204,21,97,Amazon,when would there be
2023-12-04 19:28:27,60,81,466,535,21,48,Youtube,when would there be
2023-12-04 19:28:32,7,29,80,147,22,45,Bing,search the map for new
2023-12-04 19:28:35,6,28,62,173,22,89,Amazon,search the map for new
2023-12-04 19:28:38,60,83,240,312,23,49,Youtube,search the map for new
2023-12-04 19:28:43,11,33,86,148,22,40,Bing,suggestions on finals
2023-12-04 19:28:45,15,36,68,189,21,100,Amazon,suggestions on finals
2023-12-04 19:28:48,55,77,244,312,22,46,Youtube,suggestions on finals
2023-12-04 19:28:52,9,81,265,444,72,107,Bing,start
2023-12-04 19:29:00,57,83,238,311,26,47,Youtube,start
2023-12-04 19:29:04,9,32,81,149,23,45,Bing,ending
2023-12-04 19:29:06,8,31,63,163,23,77,Amazon,ending
2023-12-04 19:29:09,53,73,232,308,20,56,Youtube,ending
2023-12-04 19:29:16,20,46,81,182,26,75,Amazon,safety
2023-12-04 19:29:21,62,84,259,354,22,73,Youtube,safety
2023-12-04 19:29:26,7,29,76,141,22,43,Bing,data
2023-12-04 19:29:29,10,33,64,159,23,72,Amazon,data
2023-12-04 19:29:32,66,91,232,301,25,44,Youtube,data
2023-12-04 19:29:37,7,27,81,142,20,41,Bing,DDIO
2023-12-04 19:29:40,14,37,70,183,23,90,Amazon,DDIO
2023-12-04 19:29:42,58,82,236,303,24,43,Youtube,DDIO
2023-12-04 19:29:46,7,30,80,145,23,42,Bing,MSFG
2023-12-04 19:29:48,10,34,73,189,24,92,Amazon,MSFG
2023-12-04 19:29:53,56,79,242,303,23,38,Youtube,MSFG
2023-12-04 19:29:57,6,30,80,146,24,42,Bing,HOA
2023-12-04 19:30:01,8,29,62,169,21,86,Amazon,HOA
2023-12-04 19:30:03,89,117,281,356,28,47,Youtube,HOA
2023-12-04 19:30:08,9,30,80,150,21,49,Bing,FAFR
2023-12-04 19:30:10,8,31,63,177,23,91,Amazon,FAFR
2023-12-04 19:30:14,58,80,246,312,22,44,Youtube,FAFR
2023-12-04 19:30:18,36,58,115,180,22,43,Bing,WieSOichDichEmpfangen
2023-12-04 19:30:20,17,40,75,179,23,81,Amazon,WieSOichDichEmpfangen
2023-12-04 19:30:24,55,86,248,333,31,54,Youtube,WieSOichDichEmpfangen
2023-12-04 19:30:28,8,31,81,468,23,364,Bing,sagmichbitte
2023-12-04 19:30:29,5,30,61,159,25,73,Amazon,sagmichbitte
2023-12-04 19:30:33,58,81,239,319,23,57,Youtube,sagmichbitte
2023-12-04 19:30:37,9,31,82,147,22,43,Bing,ilAuraitSuffi
2023-12-04 19:30:39,28,51,83,265,23,159,Amazon,ilAuraitSuffi
2023-12-04 19:30:42,64,87,243,321,23,55,Youtube,ilAuraitSuffi
dateTime,connectStart,secureConnectionStart,requestStart,responseStart,networkTime,serverTime,service site,searching string
2023-12-04 19:19:49,6,27,78,164,21,65,Bing,Carnegie Mellon University
2023-12-04 19:19:51,7,29,59,157,22,76,Amazon,Carnegie Mellon University
2023-12-04 19:19:57,52,74,230,301,22,49,Youtube,Carnegie Mellon University
2023-12-04 19:20:02,10,32,88,171,22,61,Bing,Airbnb
2023-12-04 19:20:05,7,47,79,336,40,217,Amazon,Airbnb
2023-12-04 19:20:11,66,98,296,372,32,44,Youtube,Airbnb
2023-12-04 19:20:15,28,49,99,179,21,59,Bing,Facebook
2023-12-04 19:20:19,7,29,59,169,22,88,Amazon,Facebook
2023-12-04 19:20:24,66,89,264,325,23,38,Youtube,Facebook
2023-12-04 19:20:29,7,27,315,399,20,64,Bing,Youtube
2023-12-04 19:20:31,15,38,73,368,23,272,Amazon,Youtube
2023-12-04 19:20:34,47,71,202,274,24,48,Youtube,Youtube
2023-12-04 19:20:40,9,31,78,160,22,60,Bing,cirtic
2023-12-04 19:20:42,6,29,62,170,23,85,Amazon,cirtic
2023-12-04 19:20:47,49,71,457,520,22,41,Youtube,cirtic
2023-12-04 19:20:55,9,30,84,171,21,66,Bing,when would there be
2023-12-04 19:21:02,145,183,1020,1082,38,24,Youtube,when would there be
2023-12-04 19:21:08,8,40,195,279,32,52,Bing,search the map for new
2023-12-04 19:21:11,9,33,62,202,24,116,Amazon,search the map for new
2023-12-04 19:21:16,62,85,243,307,23,41,Youtube,search the map for new
2023-12-04 19:21:21,12,45,104,188,33,51,Bing,suggestions on finals
2023-12-04 19:21:25,6,27,66,422,21,335,Amazon,suggestions on finals
2023-12-04 19:21:31,101,125,289,351,24,38,Youtube,suggestions on finals
2023-12-04 19:21:36,26,49,99,165,23,43,Bing,start
2023-12-04 19:21:41,8,30,60,234,22,152,Amazon,start
2023-12-04 19:21:45,57,85,245,322,28,49,Youtube,start
2023-12-04 19:21:49,8,31,86,173,23,64,Bing,ending
2023-12-04 19:21:52,10,34,66,158,24,68,Amazon,ending
2023-12-04 19:21:56,73,97,270,343,24,49,Youtube,ending
2023-12-04 19:22:00,8,29,78,143,21,44,Bing,safety
2023-12-04 19:22:04,6,29,61,175,23,91,Amazon,safety
2023-12-04 19:22:07,66,89,256,344,23,65,Youtube,safety
2023-12-04 19:22:11,26,51,103,167,25,39,Bing,data
2023-12-04 19:22:15,23,46,79,184,23,82,Amazon,data
2023-12-04 19:22:19,79,105,269,434,26,139,Youtube,data
2023-12-04 19:22:23,9,29,83,152,20,49,Bing,DDIO
2023-12-04 19:22:26,12,34,65,178,22,91,Amazon,DDIO
2023-12-04 19:22:30,46,69,243,310,23,44,Youtube,DDIO
2023-12-04 19:22:35,8,33,89,156,25,42,Bing,MSFG
2023-12-04 19:22:37,4,27,64,192,23,105,Amazon,MSFG
2023-12-04 19:22:43,62,85,249,319,23,47,Youtube,MSFG
2023-12-04 19:22:48,9,30,78,145,21,46,Bing,HOA
2023-12-04 19:22:50,15,38,71,181,23,87,Amazon,HOA
2023-12-04 19:22:52,68,91,249,311,23,39,Youtube,HOA
2023-12-04 19:22:56,7,27,76,145,20,49,Bing,FAFR
2023-12-04 19:23:00,8,31,61,166,23,82,Amazon,FAFR
2023-12-04 19:23:03,61,90,251,315,29,35,Youtube,FAFR
2023-12-04 19:23:08,18,40,95,164,22,47,Bing,WieSOichDichEmpfangen
2023-12-04 19:23:10,4,25,57,171,21,93,Amazon,WieSOichDichEmpfangen
2023-12-04 19:23:17,9,29,76,184,20,88,Bing,sagmichbitte
2023-12-04 19:23:21,50,72,233,304,22,49,Youtube,sagmichbitte
2023-12-04 19:23:27,9,32,65,221,23,133,Amazon,ilAuraitSuffi
2023-12-04 19:23:30,34,55,215,297,21,61,Youtube,ilAuraitSuffi
2023-12-04 19:23:44,9,28,76,142,19,47,Bing,Carnegie Mellon University
2023-12-04 19:23:51,11,51,91,196,40,65,Amazon,Carnegie Mellon University
2023-12-04 19:23:57,29,176,514,696,147,35,Youtube,Carnegie Mellon University
2023-12-04 19:24:01,7,29,77,146,22,47,Bing,Airbnb
2023-12-04 19:24:04,9,31,62,176,22,92,Amazon,Airbnb
2023-12-04 19:24:09,54,80,241,326,26,59,Youtube,Airbnb
2023-12-04 19:24:13,10,33,88,158,23,47,Bing,Facebook
2023-12-04 19:24:17,10,34,65,247,24,158,Amazon,Facebook
2023-12-04 19:24:20,55,78,241,304,23,40,Youtube,Facebook
2023-12-04 19:24:24,8,28,78,142,20,44,Bing,Youtube
2023-12-04 19:24:29,16,43,82,277,27,168,Amazon,Youtube
2023-12-04 19:24:32,70,92,229,301,22,50,Youtube,Youtube
2023-12-04 19:24:36,8,29,84,149,21,44,Bing,cirtic
2023-12-04 19:24:38,5,28,57,163,23,83,Amazon,cirtic
2023-12-04 19:24:42,50,179,689,1090,129,272,Youtube,cirtic
2023-12-04 19:24:46,26,48,102,179,22,55,Bing,when would there be
2023-12-04 19:24:48,21,58,95,212,37,80,Amazon,when would there be
2023-12-04 19:24:51,49,71,230,321,22,69,Youtube,when would there be
2023-12-04 19:24:56,6,29,77,144,23,44,Bing,search the map for new
2023-12-04 19:24:58,28,50,87,189,22,80,Amazon,search the map for new
2023-12-04 19:25:03,55,79,246,338,24,68,Youtube,search the map for new
2023-12-04 19:25:07,1701735906680,1701735906701,1701735906753,1701735906817,21,43,Bing,suggestions on finals
2023-12-04 19:25:09,6,30,63,168,24,81,Amazon,suggestions on finals
2023-12-04 19:25:13,58,79,243,317,21,53,Youtube,suggestions on finals
2023-12-04 19:25:17,14,38,90,155,24,41,Bing,start
2023-12-04 19:25:20,12,34,65,181,22,94,Amazon,start
2023-12-04 19:25:22,67,88,250,325,21,54,Youtube,start
2023-12-04 19:25:30,6,29,62,162,23,77,Amazon,ending
2023-12-04 19:25:33,57,82,239,323,25,59,Youtube,ending
2023-12-04 19:25:39,7,29,400,467,22,45,Bing,safety
2023-12-04 19:25:41,13,38,83,186,25,78,Amazon,safety
2023-12-04 19:25:46,44,67,237,306,23,46,Youtube,safety
2023-12-04 19:25:50,11,33,83,155,22,50,Bing,data
2023-12-04 19:25:53,7,30,387,490,23,80,Amazon,data
2023-12-04 19:25:56,61,83,703,795,22,70,Youtube,data
2023-12-04 19:26:00,9,30,75,141,21,45,Bing,DDIO
2023-12-04 19:26:03,10,34,65,157,24,68,Amazon,DDIO
2023-12-04 19:26:07,54,76,499,572,22,51,Youtube,DDIO
2023-12-04 19:26:12,7,28,481,546,21,44,Bing,MSFG
2023-12-04 19:26:14,14,36,67,190,22,101,Amazon,MSFG
2023-12-04 19:26:17,85,121,317,380,36,27,Youtube,MSFG
2023-12-04 19:26:22,17,41,161,229,24,44,Bing,HOA
2023-12-04 19:26:24,43,69,104,216,26,86,Amazon,HOA
2023-12-04 19:26:28,86,109,271,341,23,47,Youtube,HOA
2023-12-04 19:26:36,21,46,83,198,25,90,Amazon,FAFR
2023-12-04 19:26:40,68,93,261,327,25,41,Youtube,FAFR
2023-12-04 19:26:44,26,49,97,160,23,40,Bing,WieSOichDichEmpfangen
2023-12-04 19:26:46,6,28,64,163,22,77,Amazon,WieSOichDichEmpfangen
2023-12-04 19:26:50,66,92,260,324,26,38,Youtube,WieSOichDichEmpfangen
2023-12-04 19:26:54,9,34,94,162,25,43,Bing,sagmichbitte
2023-12-04 19:26:55,5,29,63,178,24,91,Amazon,sagmichbitte
2023-12-04 19:26:59,54,80,542,608,26,40,Youtube,sagmichbitte
2023-12-04 19:27:04,9,32,84,148,23,41,Bing,ilAuraitSuffi
2023-12-04 19:27:06,8,30,64,177,22,91,Amazon,ilAuraitSuffi
2023-12-04 19:27:11,38,61,221,289,23,45,Youtube,ilAuraitSuffi
2023-12-04 19:27:26,13,38,498,563,25,40,Bing,Carnegie Mellon University
2023-12-04 19:27:29,8,38,69,171,30,72,Amazon,Carnegie Mellon University
2023-12-04 19:27:33,69,69,1331,1415,0,84,Youtube,Carnegie Mellon University
2023-12-04 19:27:41,26,52,109,174,26,39,Bing,Airbnb
2023-12-04 19:27:43,16,38,71,182,22,89,Amazon,Airbnb
2023-12-04 19:27:50,116,139,764,829,23,42,Youtube,Airbnb
2023-12-04 19:27:54,5,27,75,142,22,45,Bing,Facebook
2023-12-04 19:27:56,15,36,70,169,21,78,Amazon,Facebook
2023-12-04 19:28:06,15,43,94,162,28,40,Bing,Youtube
2023-12-04 19:28:08,8,30,63,167,22,82,Amazon,Youtube
2023-12-04 19:28:11,67,88,252,319,21,46,Youtube,Youtube
2023-12-04 19:28:15,8,29,78,141,21,42,Bing,cirtic
2023-12-04 19:28:18,25,47,82,182,22,78,Amazon,cirtic
2023-12-04 19:28:22,48,69,226,294,21,47,Youtube,cirtic
2023-12-04 19:28:28,9,33,84,146,24,38,Bing,when would there be
2023-12-04 19:28:30,9,31,65,175,22,88,Amazon,when would there be
2023-12-04 19:28:33,46,68,227,300,22,51,Youtube,when would there be
2023-12-04 19:28:38,13,36,105,179,23,51,Bing,search the map for new
2023-12-04 19:28:41,10,31,71,177,21,85,Amazon,search the map for new
2023-12-04 19:28:43,56,77,233,315,21,61,Youtube,search the map for new
2023-12-04 19:28:48,27,47,106,169,20,43,Bing,suggestions on finals
2023-12-04 19:28:51,8,32,68,167,24,75,Amazon,suggestions on finals
2023-12-04 19:28:57,41,112,634,819,71,114,Youtube,suggestions on finals
2023-12-04 19:29:02,28,50,97,162,22,43,Bing,start
2023-12-04 19:29:04,9,31,65,165,22,78,Amazon,start
2023-12-04 19:29:07,47,70,231,310,23,56,Youtube,start
2023-12-04 19:29:11,12,34,83,149,22,44,Bing,ending
2023-12-04 19:29:13,10,31,65,155,21,69,Amazon,ending
2023-12-04 19:29:17,50,71,237,319,21,61,Youtube,ending
2023-12-04 19:29:22,7,29,82,147,22,43,Bing,safety
2023-12-04 19:29:24,28,50,83,177,22,72,Amazon,safety
2023-12-04 19:29:27,81,102,259,317,21,37,Youtube,safety
2023-12-04 19:29:33,8,30,95,578,22,461,Bing,data
2023-12-04 19:29:35,12,34,74,175,22,79,Amazon,data
2023-12-04 19:29:38,42,65,228,324,23,73,Youtube,data
2023-12-04 19:29:43,30,49,111,173,19,43,Bing,DDIO
2023-12-04 19:29:44,43,67,98,202,24,80,Amazon,DDIO
2023-12-04 19:29:47,24,48,206,284,24,54,Youtube,DDIO
2023-12-04 19:29:55,6,29,60,176,23,93,Amazon,MSFG
2023-12-04 19:29:59,74,96,255,331,22,54,Youtube,MSFG
2023-12-04 19:30:04,9,33,167,230,24,39,Bing,HOA
2023-12-04 19:30:06,51,73,106,230,22,102,Amazon,HOA
2023-12-04 19:30:14,7,29,99,166,22,45,Bing,FAFR
2023-12-04 19:30:17,10,36,65,165,26,74,Amazon,FAFR
2023-12-04 19:30:19,53,75,234,294,22,38,Youtube,FAFR
2023-12-04 19:30:24,9,30,79,146,21,46,Bing,WieSOichDichEmpfangen
2023-12-04 19:30:26,9,32,65,161,23,73,Amazon,WieSOichDichEmpfangen
2023-12-04 19:30:29,53,76,235,305,23,47,Youtube,WieSOichDichEmpfangen
2023-12-04 19:30:33,9,30,83,149,21,45,Bing,sagmichbitte
2023-12-04 19:30:35,6,30,63,221,24,134,Amazon,sagmichbitte
2023-12-04 19:30:38,50,72,232,296,22,42,Youtube,sagmichbitte
2023-12-04 19:30:45,8,30,59,491,22,410,Amazon,ilAuraitSuffi
2023-12-04 19:30:48,29,52,211,287,23,53,Youtube,ilAuraitSuffi
